sg_uf,cd_municipio,nm_municipio,jair_bolsonaro_1turno,jair_bolsonaro_2turno,lula_1turno,lula_2turno,queda_lula_percentual,aumento_bolsonaro_percentual,diferenca_lula_votos,diferenca_bolsonaro_votos,sigla_partido_prefeito_2020
AC,1007,BUJARI,4505,4693,2130,1958,-8.07511737089202,4.17314095449501,-172,188,PDT
AC,1015,CAPIXABA,3944,3963,1630,1497,-8.15950920245399,0.481744421906694,-133,19,DEM
AC,1023,PORTO ACRE,7062,7384,2490,2317,-6.94779116465863,4.55961483998868,-173,322,PP
AC,1031,SANTA ROSA DO PURUS,1028,1127,1357,1217,-10.3168754605748,9.63035019455254,-140,99,MDB
AC,1058,BRASILÉIA,9143,9593,4171,3958,-5.10668904339488,4.92179809690474,-213,450,PT
AC,1074,CRUZEIRO DO SUL,30977,31936,10770,9733,-9.62859795728876,3.09584530458082,-1037,959,PP
AC,1112,EPITACIOLÂNDIA,6494,6729,2592,2464,-4.93827160493827,3.61872497690177,-128,235,PSDB
AC,1120,ACRELÂNDIA,5238,5317,1516,1460,-3.69393139841688,1.50820924016801,-56,79,MDB
AC,1139,FEIJÓ,6191,6383,7930,7113,-10.3026481715006,3.10127604587305,-817,192,PP
AC,1490,XAPURI,5142,5217,3774,3634,-3.70959194488606,1.4585764294049,-140,75,PT
AC,1538,SENADOR GUIOMARD,9134,9512,3523,3338,-5.25120635821743,4.13838405955769,-185,378,PP
AC,1570,ASSIS BRASIL,2694,2717,2003,1895,-5.3919121318023,0.853749072011878,-108,23,PT
AL,27006,PARIPUEIRA,3924,4187,3984,3742,-6.07429718875502,6.70234454638123,-242,263,DEM
AL,27030,ANADIA,1797,2019,6234,6166,-1.09079242861726,12.3539232053422,-68,222,PP
AL,27065,JEQUIÁ DA PRAIA,2669,2854,3064,2832,-7.57180156657964,6.93143499437992,-232,185,PP
AL,27073,ATALAIA,7105,7544,13894,13340,-3.98733266158053,6.17874736101338,-554,439,PSC
AL,27090,BARRA DE SANTO ANTÔNIO,3400,3586,5358,5155,-3.78872713699141,5.47058823529412,-203,186,PTB
AL,27111,BARRA DE SÃO MIGUEL,2769,2871,2739,2699,-1.46038700255567,3.68364030335862,-40,102,PP
AL,27154,BELÉM,790,886,2442,2406,-1.47420147420148,12.1518987341772,-36,96,MDB
AL,27170,BELO MONTE,1006,1057,3192,3113,-2.4749373433584,5.06958250497018,-79,51,PTB
AL,27197,BOCA DA MATA,4872,5359,7789,7724,-0.834510206701755,9.99589490968802,-65,487,MDB
AL,27219,BRANQUINHA,1471,1571,4230,4041,-4.46808510638298,6.79809653297077,-189,100,MDB
AL,27235,CACIMBINHAS,1310,1440,4189,4147,-1.00262592504178,9.92366412213741,-42,130,MDB
AL,27251,CAJUEIRO,2840,2991,6482,6416,-1.01820425794508,5.31690140845071,-66,151,PODE
AL,27278,CAMPO ALEGRE,5279,6012,11834,11486,-2.94067939834376,13.8852055313506,-348,733,PP
AL,27294,CAMPO GRANDE,1136,1197,5082,5048,-0.669027941755218,5.36971830985915,-34,61,
AL,27316,CANAPI,1239,1365,7512,7473,-0.519169329073488,10.1694915254237,-39,126,PP
AL,27332,CAPELA,3392,3523,5477,5228,-4.54628446229688,3.8620283018868,-249,131,MDB
AL,27359,CARNEIROS,726,810,3945,3888,-1.44486692015209,11.5702479338843,-57,84,MDB
AL,27375,CHÃ PRETA,909,963,3193,3126,-2.09834011901033,5.94059405940595,-67,54,MDB
AL,27391,COITÉ DO NÓIA,1109,1378,5049,5033,-0.316894434541493,24.2560865644725,-16,269,PP
AL,27413,COLÔNIA LEOPOLDINA,4190,4366,5517,5286,-4.18705818379554,4.20047732696898,-231,176,MDB
AL,27430,COQUEIRO SECO,1300,1446,2367,2270,-4.09801436417406,11.2307692307692,-97,146,MDB
AL,27456,CORURIPE,13580,14497,13124,12675,-3.42121304480342,6.75257731958763,-449,917,PP
AL,27499,DOIS RIACHOS,1399,1460,4778,4705,-1.52783591460862,4.3602573266619,-73,61,MDB
AL,27553,FLEXEIRAS,2685,2841,3001,2795,-6.8643785404865,5.81005586592178,-206,156,PP
AL,27650,INHAPI,1213,1387,7310,7228,-1.12175102599179,14.3446001648805,-82,174,PP
AL,27677,JACARÉ DOS HOMENS,610,651,2829,2788,-1.44927536231884,6.72131147540984,-41,41,MDB
AL,27715,JAPARATINGA,2754,2766,2426,2300,-5.19373454245672,0.435729847494559,-126,12,PTB
AL,27731,JARAMATAIA,702,760,2843,2802,-1.44213858600071,8.26210826210827,-41,58,MDB
AL,27758,JOAQUIM GOMES,2685,2751,7065,6755,-4.38782731776363,2.45810055865923,-310,66,PTB
AL,27790,JUNQUEIRO,4195,4665,9073,9065,-0.0881737021933171,11.2038140643623,-8,470,PTB
AL,27812,LAGOA DA CANOA,2722,3278,8047,8000,-0.584068596992671,20.4261572373255,-47,556,PP
AL,27839,LIMOEIRO DE ANADIA,2946,3331,10502,10488,-0.133307941344507,13.0685675492193,-14,385,PP
AL,27871,MAJOR ISIDORO,3012,3361,7253,7106,-2.0267475527368,11.5869853917663,-147,349,PP
AL,27898,MARAGOGI,8865,9451,6966,6924,-0.602928509905254,6.61026508742244,-42,586,PP
AL,27936,MARECHAL DEODORO,15343,16560,13719,13267,-3.29470077994023,7.93195594081992,-452,1217,MDB
AL,27952,MARIBONDO,2356,2425,4974,4770,-4.10132689987938,2.92869269949065,-204,69,PSD
AL,27979,MAR VERMELHO,659,752,1942,1871,-3.65602471678682,14.1122913505311,-71,93,MDB
AL,27995,MATA GRANDE,1814,1976,9432,9251,-1.91899915182358,8.93054024255788,-181,162,PTB
AL,28037,MESSIAS,3675,3936,5776,5542,-4.05124653739613,7.10204081632653,-234,261,PTB
AL,28096,MURICI,4630,4827,8770,8202,-6.47662485746864,4.25485961123111,-568,197,MDB
AL,28231,PALESTINA,600,658,2442,2354,-3.6036036036036,9.66666666666667,-88,58,REPUBLICANOS
AL,28258,PALMEIRA DOS ÍNDIOS,12279,13468,24549,23869,-2.76997026355452,9.68319895756984,-680,1189,PSB
AL,28274,PÃO DE AÇÚCAR,2810,2966,9991,9656,-3.35301771594435,5.55160142348754,-335,156,PSDB
AL,28290,PASSO DE CAMARAGIBE,3278,3388,5249,5016,-4.43894075061917,3.35570469798658,-233,110,PTB
AL,28312,PAULO JACINTO,1147,1247,3234,3059,-5.41125541125541,8.71839581517,-175,100,DEM
AL,28339,PENEDO,9757,10513,18665,18554,-0.594695954995983,7.74828328379624,-111,756,MDB
AL,28355,PIAÇABUÇU,2830,3013,6621,6131,-7.40069475909984,6.46643109540637,-490,183,REPUBLICANOS
AL,28398,PINDOBA,586,594,1364,1261,-7.55131964809385,1.36518771331058,-103,8,PTB
AL,28479,PORTO DE PEDRAS,2235,2237,2832,2725,-3.77824858757062,0.0894854586129812,-107,2,MDB
AL,28495,PORTO REAL DO COLÉGIO,2237,2405,9354,9211,-1.52875775069489,7.51005811354493,-143,168,MDB
AL,28517,QUEBRANGULO,1672,1733,5252,5173,-1.5041888804265,3.64832535885167,-79,61,MDB
AL,28533,RIO LARGO,20242,22173,24603,24037,-2.30053245539162,9.53957118861772,-566,1931,PP
AL,28550,ROTEIRO,1380,1462,2381,2250,-5.50188996220076,5.94202898550724,-131,82,PP
AL,28576,SANTA LUZIA DO NORTE,1544,1753,3033,2859,-5.73689416419386,13.5362694300518,-174,209,PP
AL,28592,SANTANA DO IPANEMA,5387,6028,17264,17056,-1.20481927710844,11.8990161499907,-208,641,MDB
AL,28657,SÃO JOSÉ DA LAJE,4277,4825,7207,7030,-2.45594560843624,12.8127191956979,-177,548,PP
AL,28690,SÃO LUÍS DO QUITUNDE,6839,7169,8611,8389,-2.57809778190686,4.82526685187894,-222,330,MDB
AL,28711,SÃO MIGUEL DOS CAMPOS,13946,14924,15501,15449,-0.335462228243344,7.01276351642048,-52,978,MDB
AL,28738,SÃO MIGUEL DOS MILAGRES,2407,2447,2718,2648,-2.57542310522443,1.66181969256336,-70,40,PTB
AL,28754,SÃO SEBASTIÃO,3872,4612,13823,13701,-0.882586992693335,19.1115702479339,-122,740,PP
AL,28770,SATUBA,4519,4973,4732,4646,-1.8174133558749,10.0464704580659,-86,454,PP
AL,28835,TRAIPU,2204,2371,9935,9934,-0.0100654252642163,7.57713248638838,-1,167,MDB
AL,28851,UNIÃO DOS PALMARES,11002,11875,19983,19944,-0.195165891007354,7.93492092346846,-39,873,MDB
AL,28878,VIÇOSA,4648,4960,9441,9237,-2.16078805211313,6.71256454388984,-204,312,REPUBLICANOS
AM,2003,APUÍ,4600,4924,2885,2809,-2.63431542461006,7.04347826086957,-76,324,PSC
AM,2011,NOVO AIRÃO,3677,3727,4505,4166,-7.52497225305216,1.3598041881969,-339,50,PSC
AM,2020,GUAJARÁ,4154,4407,3135,2891,-7.78309409888357,6.09051516610495,-244,253,PP
AM,2054,ATALAIA DO NORTE,1051,1136,4724,4660,-1.35478408128704,8.08753568030447,-64,85,PSC
AM,2097,BARCELOS,2299,2483,4675,4616,-1.26203208556149,8.0034797738147,-59,184,MDB
AM,2119,BARREIRINHA,1207,1327,14691,14079,-4.16581580559526,9.94200497100248,-612,120,MDB
AM,2135,BENJAMIN CONSTANT,2372,2623,13665,13370,-2.15879985364069,10.5817875210793,-295,251,MDB
AM,2151,BOCA DO ACRE,7640,8499,7234,7050,-2.54354437379043,11.2434554973822,-184,859,PP
AM,2178,BORBA,3231,3281,12422,12371,-0.410561906295281,1.54750851129681,-51,50,PP
AM,2194,CANUTAMA,2657,2951,3835,3539,-7.71838331160365,11.0651110274746,-296,294,PSC
AM,2232,CAREIRO,5472,5570,10450,9949,-4.79425837320574,1.79093567251463,-501,98,REPUBLICANOS
AM,2259,COARI,12717,12829,20449,19841,-2.97325052569808,0.880710859479428,-608,112,
AM,2330,FONTE BOA,2446,2480,8484,8421,-0.742574257425743,1.39002452984465,-63,34,PL
AM,2356,HUMAITÁ,9836,10935,12604,12406,-1.57092986353539,11.173241154941,-198,1099,PSC
AM,2372,SANTA ISABEL DO RIO NEGRO,1253,1305,3824,3703,-3.16422594142259,4.15003990422984,-121,52,PP
AM,2410,ITACOATIARA,16981,17807,33435,31621,-5.42545237027068,4.86426005535598,-1814,826,PSC
AM,2437,ITAPIRANGA,2450,2457,3679,3538,-3.83256319652079,0.285714285714289,-141,7,PP
AM,2470,JURUÁ,1706,1801,3019,2870,-4.93540907585294,5.5685814771395,-149,95,MDB
AM,2518,LÁBREA,5785,6242,12010,11683,-2.72273105745212,7.89974070872948,-327,457,MDB
AM,2534,MANACAPURU,22942,23667,30532,28386,-7.02869120922312,3.16014296922675,-2146,725,REPUBLICANOS
AM,2577,MANICORÉ,7486,8056,15479,15172,-1.98333225660572,7.61421319796953,-307,570,PSD
AM,2631,NHAMUNDÁ,1440,1457,9242,8939,-3.27851114477385,1.18055555555556,-303,17,PSD
AM,2658,NOVA OLINDA DO NORTE,2531,2673,10813,10114,-6.46444095070748,5.61043065981826,-699,142,MDB
AM,2674,NOVO ARIPUANÃ,2021,2105,6804,6747,-0.837742504409167,4.15635823849578,-57,84,PSDB
AM,2690,PARINTINS,7930,8809,43220,41689,-3.54234150856085,11.0844892812106,-1531,879,DEM
AM,2712,PAUINI,2045,2237,5206,4838,-7.06876680752977,9.38875305623472,-368,192,PSD
AM,2739,SANTO ANTÔNIO DO IÇÁ,3027,3150,8905,8849,-0.62886019090399,4.06342913776017,-56,123,REPUBLICANOS
AM,2771,SILVES,1043,1081,5151,4771,-7.3772083090662,3.64333652924258,-380,38,
AM,2810,TEFÉ,10897,11300,20784,20281,-2.42013086989993,3.69826557768194,-503,403,PTB
AM,2852,URUCARÁ,1764,1908,6686,6317,-5.51899491474723,8.16326530612246,-369,144,MDB
AM,2879,URUCURITUBA,1810,1836,7577,7073,-6.65170911970436,1.43646408839779,-504,26,PT
AM,2895,ALVARÃES,1997,2102,6014,5978,-0.598603259062192,5.25788683024537,-36,105,PSC
AM,2933,ANAMÃ,2041,2051,3927,3733,-4.94015788133435,0.489955903968653,-194,10,PSC
AM,2976,BOA VISTA DO RAMOS,985,1072,8269,7837,-5.22433184181884,8.83248730964468,-432,87,PSC
AM,98353,IRANDUBA,11829,12590,16381,15304,-6.5746901898541,6.43334178713331,-1077,761,DEM
AM,98418,PRESIDENTE FIGUEIREDO,7515,7935,9350,9038,-3.33689839572192,5.58882235528941,-312,420,
AM,98434,RIO PRETO DA EVA,5848,6081,7313,6752,-7.67127034048954,3.984268125855,-561,233,PP
AM,98477,TABATINGA,7795,8582,17437,17368,-0.395710271262262,10.096215522771,-69,787,MDB
AM,98493,UARINI,1859,1936,4335,4087,-5.72087658592849,4.14201183431953,-248,77,PSD
AM,98515,TONANTINS,1237,1298,6363,6307,-0.880088008800883,4.93128536782539,-56,61,REPUBLICANOS
AP,6025,PORTO GRANDE,4058,4112,5510,5120,-7.07803992740472,1.33070478068014,-390,54,PDT
AP,6076,MAZAGÃO,4924,4967,9808,8466,-13.6827079934747,0.873273761169791,-1342,43,PSL
AP,6092,OIAPOQUE,4353,4444,8885,8150,-8.27236916150816,2.09051229037445,-735,91,PRTB
AP,6130,LARANJAL DO JARI,7198,7296,12198,11222,-8.00131169044106,1.36148930258404,-976,98,DEM
AP,6157,SANTANA,32615,35397,28840,27693,-3.97711511789182,8.5298175686034,-1147,2782,PP
BA,30694,JUSSARI,1082,1183,2119,2111,-0.377536573855597,9.33456561922366,-8,101,PSD
BA,30732,ARATACA,1149,1236,3091,2988,-3.33225493367842,7.57180156657964,-103,87,PSD
BA,33316,ANTAS,1960,2491,5699,5682,-0.298297947008253,27.0918367346939,-17,531,PSB
BA,34070,CAIRU,3211,3539,6846,6798,-0.701139351446101,10.2148863282467,-48,328,DEM
BA,34096,CALDEIRÃO GRANDE,1164,1915,5986,5815,-2.85666555295689,64.5189003436426,-171,751,PP
BA,34193,CAMPO FORMOSO,10017,12308,30654,30504,-0.489332550401256,22.8711190975342,-150,2291,DEM
BA,35530,IBIQUERA,352,405,2371,2316,-2.31969633066217,15.0568181818182,-55,53,PP
BA,35831,IPUPIARA,1632,2067,4593,4513,-1.74178097104289,26.6544117647059,-80,435,PP
BA,36030,ITAGI,1927,2335,4861,4857,-0.0822875951450364,21.1728074727556,-4,408,DEM
BA,36099,ITAJU DO COLÔNIA,1489,1541,2269,2206,-2.77655354781842,3.49227669576897,-63,52,PSD
BA,36838,LAMARÃO,529,629,5014,4997,-0.339050658157158,18.9035916824197,-17,100,PT
BA,36994,MACURURÉ,603,666,4209,4186,-0.546448087431695,10.4477611940299,-23,63,PC do B
BA,37273,MILAGRES,1517,1663,5078,5062,-0.315084679007482,9.62425840474621,-16,146,PP
BA,37397,MUCUGÊ,1981,2432,5054,4977,-1.52354570637119,22.766279656739,-77,451,DEM
BA,37460,MUQUÉM DO SÃO FRANCISCO,1415,1582,5581,5516,-1.16466583049633,11.8021201413428,-65,167,PT
BA,38431,RODELAS,893,994,4823,4774,-1.01596516690856,11.3101903695409,-49,101,PC do B
BA,38571,SANTA CRUZ DA VITÓRIA,1011,1227,2005,1896,-5.43640897755611,21.3649851632048,-109,216,PSDB
BA,38911,SAPEAÇU,2120,2881,9300,9229,-0.763440860215059,35.8962264150943,-71,761,DEM
BA,39144,SÍTIO DO MATO,1663,1894,6112,6103,-0.14725130890052,13.8905592303067,-9,231,PSD
BA,39489,UMBURANAS,2182,2347,5932,5911,-0.354012137559001,7.56186984417966,-21,165,DEM
BA,39691,WENCESLAU GUIMARÃES,2981,3350,8412,8354,-0.689491203043269,12.3783965112378,-58,369,REPUBLICANOS
BA,39772,MANSIDÃO,1021,1100,5517,5491,-0.471270618089537,7.73751224289911,-26,79,SOLIDARIEDADE
BA,39926,SÃO JOSÉ DA VITÓRIA,1266,1341,2139,2135,-0.187003272557273,5.92417061611374,-4,75,PSB
BA,39969,NOVA IBIÁ,1195,1304,2504,2487,-0.678913738019171,9.12133891213389,-17,109,PSD
CE,13269,POTIRETAMA,619,672,4029,4002,-0.670141474311248,8.56219709208401,-27,53,PP
CE,13382,BANABUIÚ,1781,1941,9706,9632,-0.762415001030292,8.9837170129141,-74,160,PDT
CE,13463,CHORÓ,1326,1492,7288,7107,-2.48353457738749,12.5188536953243,-181,166,PL
CE,13595,CARIDADE,2180,2420,10777,10675,-0.946460053818321,11.0091743119266,-102,240,PDT
CE,14060,IBARETAMA,1615,1851,7809,7718,-1.1653220642848,14.6130030959752,-91,236,PSD
ES,56006,SÃO DOMINGOS DO NORTE,2727,3036,2996,2935,-2.03604806408545,11.3311331133113,-61,309,DEM
ES,56090,APIACÁ,2145,2356,2208,2172,-1.63043478260869,9.83682983682983,-36,211,PP
ES,56138,ATÍLIO VIVÁCQUA,3488,3806,3182,3130,-1.63419233186675,9.11697247706422,-52,318,PDT
ES,56146,BREJETUBA,3689,4149,3013,2941,-2.38964487222038,12.4695039306045,-72,460,PDT
ES,56154,BAIXO GUANDU,9209,10069,7611,7577,-0.446721849954013,9.33869041155391,-34,860,SOLIDARIEDADE
ES,56189,SOORETAMA,6417,7205,7203,7118,-1.1800638622796,12.2798815645941,-85,788,REPUBLICANOS
ES,56219,BOM JESUS DO NORTE,2758,3041,2681,2677,-0.149198060425215,10.2610587382161,-4,283,PMN
ES,56227,VILA VALÉRIO,4019,4367,5276,5183,-1.76269901440486,8.65887036576263,-93,348,PP
ES,56316,CONCEIÇÃO DA BARRA,5250,5815,9740,9708,-0.328542094455853,10.7619047619048,-32,565,PTB
ES,56502,IBITIRAMA,3396,3783,1757,1728,-1.6505406943654,11.3957597173145,-29,387,PSD
ES,56618,JERÔNIMO MONTEIRO,3564,4045,3273,3227,-1.40543843568591,13.4960718294052,-46,481,PSD
ES,56693,MONTANHA,4283,4805,5844,5755,-1.52292950034223,12.1877188886295,-89,522,PSB
ES,56774,NOVA VENÉCIA,13657,14891,13420,13255,-1.22950819672131,9.03565936882185,-165,1234,PDT
ES,56790,PANCAS,5331,5835,5036,5026,-0.198570293884037,9.45413618458075,-10,504,PDT
ES,56812,PINHEIROS,4641,5180,8069,8064,-0.0619655471557845,11.6138763197587,-5,539,CIDADANIA
ES,56839,PIÚMA,7077,7657,4911,4908,-0.0610873549175328,8.19556309170553,-3,580,CIDADANIA
ES,56855,PRESIDENTE KENNEDY,5648,6043,3492,3478,-0.400916380297822,6.99362606232294,-14,395,PSD
ES,56936,SÃO GABRIEL DA PALHA,9876,10467,8018,7866,-1.8957345971564,5.98420413122722,-152,591,PSL
ES,57134,JAGUARÉ,6203,6826,9973,9803,-1.70460242655169,10.0435273254877,-170,623,CIDADANIA
ES,57150,PEDRO CANÁRIO,4671,5170,7320,7296,-0.327868852459012,10.6829372725326,-24,499,REPUBLICANOS
ES,57991,ÁGUIA BRANCA,2466,2732,3799,3781,-0.473808897078176,10.786699107867,-18,266,CIDADANIA
GO,92061,CAMPOS VERDES,907,961,1951,1927,-1.23013839056894,5.95369349503858,-24,54,MDB
GO,92126,COLINAS DO SUL,697,761,1602,1553,-3.05867665418227,9.18220946915351,-49,64,PP
GO,92266,GOUVELÂNDIA,987,1145,1720,1717,-0.174418604651161,16.0081053698075,-3,158,PDT
GO,92347,MIMOSO DE GOIÁS,1046,1138,1206,1182,-1.99004975124378,8.79541108986617,-24,92,DEM
GO,92460,PALESTINA DE GOIÁS,1450,1613,1139,1124,-1.31694468832309,11.2413793103448,-15,163,PSC
GO,92495,ARUANÃ,2205,2417,2241,2212,-1.29406514948683,9.61451247165532,-29,212,PSDB
GO,92614,BALIZA,751,813,1252,1200,-4.15335463258786,8.25565912117177,-52,62,DEM
GO,92797,CABECEIRAS,2191,2526,2665,2661,-0.150093808630392,15.2898219990872,-4,335,PDT
GO,92827,RIO QUENTE,1554,1707,1149,1138,-0.95735422106179,9.84555984555984,-11,153,SOLIDARIEDADE
GO,92860,GUARINOS,587,634,1110,1101,-0.810810810810814,8.0068143100511,-9,47,PL
GO,92940,ALTO HORIZONTE,2426,2540,1840,1825,-0.815217391304346,4.69909315746084,-15,114,PSD
GO,93068,PEROLÂNDIA,1102,1277,1040,1028,-1.15384615384615,15.8802177858439,-12,175,DEM
GO,93084,NOVA IGUAÇU DE GOIÁS,954,1049,979,977,-0.204290091930537,9.958071278826,-2,95,PP
GO,93181,MONTIVIDIU DO NORTE,1246,1286,1283,1256,-2.10444271239283,3.21027287319422,-27,40,PP
GO,93246,UIRAPURU,782,867,1116,1098,-1.61290322580645,10.8695652173913,-18,85,DEM
GO,93289,VILA BOA,805,935,1724,1721,-0.174013921113692,16.1490683229814,-3,130,DEM
GO,93408,BONÓPOLIS,989,1030,1357,1317,-2.94767870302137,4.14560161779576,-40,41,DEM
GO,93424,PORTEIRÃO,1148,1345,1312,1267,-3.42987804878049,17.1602787456446,-45,197,PSB
GO,93548,IPIRANGA DE GOIÁS,1256,1368,1013,1008,-0.493583415597232,8.9171974522293,-5,112,PSD
GO,93580,CAMPO LIMPO DE GOIÁS,2701,3013,1697,1688,-0.530347672362996,11.551277304702,-9,312,DEM
GO,94277,IVOLÂNDIA,893,1060,1043,1038,-0.47938638542665,18.7010078387458,-5,167,DEM
GO,94471,MAIRIPOTABA,1000,1151,916,885,-3.38427947598253,15.1,-31,151,PP
GO,94650,MOIPORÁ,923,1073,670,647,-3.43283582089552,16.2513542795233,-23,150,PMN
GO,94676,MONTE ALEGRE DE GOIÁS,1047,1189,2692,2659,-1.22585438335809,13.5625596943649,-33,142,DEM
GO,94919,NOVA AMÉRICA,1005,1090,863,853,-1.15874855156431,8.45771144278606,-10,85,PSL
GO,95010,NOVO BRASIL,1349,1443,1144,1126,-1.57342657342657,6.96812453669384,-18,94,PSDB
GO,95354,PILAR DE GOIÁS,1054,1159,1533,1459,-4.82713633398565,9.96204933586338,-74,105,PSDB
GO,96512,MUNDO NOVO,1650,1838,1812,1797,-0.827814569536423,11.3939393939394,-15,188,REPUBLICANOS
GO,96539,NOVA CRIXÁS,2687,2933,3505,3411,-2.68188302425108,9.15519166356531,-94,246,PATRIOTA
GO,96571,VICENTINÓPOLIS,2344,2613,2414,2406,-0.33140016570008,11.4761092150171,-8,269,PSDB
GO,96695,ARAGUAPAZ,2056,2318,2132,2083,-2.29831144465291,12.7431906614786,-49,262,DEM
GO,96717,ARENÓPOLIS,1165,1291,1265,1233,-2.5296442687747,10.8154506437768,-32,126,PODE
GO,96873,CAMPINAÇU,1153,1257,1335,1334,-0.0749063670411942,9.01994796183869,-1,104,PL
GO,96890,SANTA ISABEL,1512,1681,1173,1169,-0.341005967604435,11.1772486772487,-4,169,PSDB
MA,7030,ALCÂNTARA,2288,2455,10006,9671,-3.34799120527683,7.29895104895104,-335,167,PL
MA,7145,BACURITUBA,369,383,3257,3142,-3.53085661651826,3.7940379403794,-115,14,PSD
MA,7218,AXIXÁ,1480,1553,6314,6297,-0.269242952169779,4.93243243243244,-17,73,PDT
MA,7226,CACHOEIRA GRANDE,1050,1065,5097,4897,-3.92387679026879,1.42857142857142,-200,15,PL
MA,7285,BOM LUGAR,1828,1954,6592,6571,-0.318567961165051,6.89277899343546,-21,126,PC do B
MA,7412,BURITI,1691,1856,13785,13359,-3.09031556039173,9.75753991720876,-426,165,PL
MA,7420,CENTRAL DO MARANHÃO,468,480,4628,4604,-0.518582541054447,2.56410256410256,-24,12,REPUBLICANOS
MA,7480,CIDELÂNDIA,2161,2380,5774,5752,-0.381018358157259,10.1341971309579,-22,219,PP
MA,7552,CARUTAPERA,3361,3494,9630,9608,-0.228452751817243,3.95715560844987,-22,133,SOLIDARIEDADE
MA,7706,ITAIPAVA DO GRAJAÚ,1638,1735,5820,5768,-0.893470790378004,5.92185592185592,-52,97,PDT
MA,7714,CURURUPU,2952,3049,15506,15297,-1.34786534244808,3.28590785907859,-209,97,PSB
MA,7722,ITINGA DO MARANHÃO,5730,6221,7039,7017,-0.312544395510728,8.56893542757418,-22,491,PSDB
MA,7919,GRAÇA ARANHA,861,922,3672,3635,-1.00762527233116,7.08478513356563,-37,61,PDT
MA,8206,SANTA FILOMENA DO MARANHÃO,780,879,3657,3653,-0.109379272627841,12.6923076923077,-4,99,PP
MA,8222,SANTANA DO MARANHÃO,1039,1058,4568,4509,-1.29159369527145,1.82868142444659,-59,19,PL
MA,8265,SÃO DOMINGOS DO AZEITÃO,968,1156,3852,3797,-1.42782969885774,19.4214876033058,-55,188,REPUBLICANOS
MA,8281,SÃO FRANCISCO DO BREJÃO,2165,2355,3592,3560,-0.890868596881955,8.77598152424943,-32,190,PSL
MA,8290,MATINHA,3230,3329,11072,11061,-0.0993497109826547,3.06501547987617,-11,99,PC do B
MA,8389,SÃO PEDRO DA ÁGUA BRANCA,2267,2435,4384,4316,-1.55109489051095,7.41067490074989,-68,168,PTB
MA,8419,MORROS,2344,2429,9620,9263,-3.71101871101871,3.62627986348123,-357,85,PL
MA,8435,NINA RODRIGUES,1148,1186,5987,5832,-2.58894270920328,3.31010452961673,-155,38,PDT
MA,8451,NOVA IORQUE,495,532,2381,2377,-0.167996640067203,7.47474747474748,-4,37,PL
MA,8605,TURILÂNDIA,1934,2142,8384,8291,-1.10925572519084,10.7549120992761,-93,208,PTB
MA,8621,VILA NOVA DOS MARTÍRIOS,2058,2207,3864,3794,-1.81159420289855,7.24003887269193,-70,149,PL
MA,8630,PENALVA,2295,2345,15401,15341,-0.389585091877154,2.17864923747277,-60,50,PP
MA,8656,PERI MIRIM,1323,1340,6731,6508,-3.31302926756797,1.28495842781557,-223,17,PC do B
MA,8818,PRESIDENTE JUSCELINO,1095,1149,5957,5859,-1.64512338425382,4.93150684931507,-98,54,PL
MA,8834,PRESIDENTE VARGAS,892,931,6375,6213,-2.54117647058824,4.37219730941705,-162,39,PDT
MA,8931,SAMBAÍBA,1150,1225,2998,2809,-6.30420280186791,6.52173913043479,-189,75,PP
MA,9059,SÃO BENEDITO DO RIO PRETO,1560,1627,9726,9571,-1.59366646103228,4.2948717948718,-155,67,PSC
MA,9253,SÃO RAIMUNDO DAS MANGABEIRAS,3246,3412,7842,7837,-0.0637592450905333,5.11398644485521,-5,166,PSD
MA,9695,MIRANDA DO NORTE,2711,2856,8884,8836,-0.540297163439896,5.34857985983033,-48,145,PL
MG,40657,ARACITABA,572,669,1185,1149,-3.03797468354431,16.958041958042,-36,97,PSDB
MG,40827,SEM PEIXE,647,722,1752,1679,-4.16666666666666,11.5919629057187,-73,75,PSD
MG,41300,PATIS,610,736,2976,2958,-0.604838709677424,20.655737704918,-18,126,PTB
MG,41785,CABECEIRA GRANDE,1736,2029,1977,1950,-1.36570561456753,16.8778801843318,-27,293,AVANTE
MG,42200,IBIRACATU,710,829,2916,2913,-0.102880658436211,16.7605633802817,-3,119,PP
MG,42277,CAMPO FLORIDO,1973,2266,2647,2626,-0.793350963354744,14.8504815002534,-21,293,PSD
MG,43117,CEDRO DO ABAETÉ,390,470,432,420,-2.77777777777778,20.5128205128205,-12,80,DEM
MG,44911,ESTRELA DALVA,678,716,1275,1248,-2.11764705882352,5.6047197640118,-27,38,PSB
MG,45578,GRUPIARA,574,774,596,529,-11.241610738255,34.8432055749129,-67,200,PSDB
MG,45713,GUARDA-MOR,1957,2270,2025,2019,-0.296296296296295,15.9938681655595,-6,313,PSDB
MG,46213,INIMUTABA,1527,1837,2784,2775,-0.323275862068961,20.3012442698101,-9,310,CIDADANIA
MG,51519,SANTA FÉ DE MINAS,506,554,1744,1734,-0.573394495412849,9.48616600790513,-10,48,PTB
MG,53317,SERRA DA SAUDADE,419,441,395,378,-4.30379746835443,5.25059665871122,-17,22,PP
MG,53619,TAPIRA,2317,2587,997,973,-2.40722166499499,11.6529995684074,-24,270,MDB
MG,53635,TAPIRAÍ,583,712,771,768,-0.389105058365757,22.1269296740995,-3,129,DEM
MS,55000,NOVA ALVORADA DO SUL,5383,5913,4832,4784,-0.993377483443714,9.84581088612297,-48,530,DEM
MS,55026,LAGUNA CARAPÃ,2393,2664,1668,1575,-5.57553956834532,11.324697033013,-93,271,MDB
MS,55042,NOVO HORIZONTE DO SUL,1275,1416,1431,1429,-0.139762403913346,11.0588235294118,-2,141,PSDB
MS,55050,PARAÍSO DAS ÁGUAS,1905,2064,888,795,-10.472972972973,8.34645669291339,-93,159,DEM
MS,55069,FIGUEIRÃO,884,977,876,871,-0.570776255707761,10.5203619909502,-5,93,PTB
MS,90034,ÁGUA CLARA,4181,4615,3428,3267,-4.69661610268378,10.380291796221,-161,434,PSD
MS,90115,AMAMBAI,10109,11008,8358,8200,-1.89040440296722,8.89306558512217,-158,899,PSDB
MS,90131,ANASTÁCIO,6364,6944,6034,5902,-2.18760357971495,9.11376492771843,-132,580,PSDB
MS,90158,ANAURILÂNDIA,1897,2100,2320,2305,-0.646551724137934,10.7011070110701,-15,203,PSDB
MS,90174,ANTÔNIO JOÃO,2730,2971,2648,2591,-2.15256797583081,8.82783882783882,-57,241,DEM
MS,90212,AQUIDAUANA,11937,12803,12259,12066,-1.5743535361775,7.25475412582726,-193,866,PSDB
MS,90298,BANDEIRANTES,2223,2415,2072,2051,-1.01351351351351,8.63697705802968,-21,192,
MS,90492,CAMAPUÃ,4253,4697,3559,3463,-2.6973869064344,10.4396896308488,-96,444,DEM
MS,90530,CARACOL,1771,1806,1550,1483,-4.32258064516129,1.97628458498025,-67,35,PSDB
MS,90557,CAARAPÓ,9003,9675,6137,6076,-0.993970995600457,7.46417860713096,-61,672,PSDB
MS,90611,CORGUINHO,1384,1489,1352,1342,-0.739644970414199,7.58670520231215,-10,105,PSDB
MS,90654,COXIM,9149,10152,8298,8215,-1.00024102193299,10.9629467701388,-83,1003,DEM
MS,90816,GUIA LOPES DA LAGUNA,2759,3008,2433,2343,-3.69913686806412,9.02500906125407,-90,249,PSDB
MS,90859,IGUATEMI,4242,4540,2997,2916,-2.7027027027027,7.02498821310702,-81,298,PP
MS,90972,JARAGUARI,1771,1934,1889,1835,-2.85865537321334,9.20383963862226,-54,163,PSDB
MS,91073,MARACAJU,13484,14714,7072,6926,-2.06447963800905,9.1219222782557,-146,1230,PSDB
MS,91111,MIRANDA,5194,5610,8380,7819,-6.69451073985681,8.00924143242203,-561,416,PSDB
MS,91138,NAVIRAÍ,16195,17697,9124,9093,-0.339763261727311,9.27446742821858,-31,1502,PSDB
MS,91154,NIOAQUE,3813,4073,3692,3578,-3.08775731310943,6.818777865198,-114,260,PSDB
MS,91278,PEDRO GOMES,2063,2257,2002,1966,-1.79820179820179,9.40378090159961,-36,194,DEM
MS,91375,PORTO MURTINHO,2697,2741,2596,2451,-5.58551617873652,1.63144234334445,-145,44,PSDB
MS,91413,RIBAS DO RIO PARDO,4865,5422,4387,4330,-1.29929336676544,11.4491264131552,-57,557,PSOL
MS,91430,RIO BRILHANTE,10106,10973,7852,7765,-1.1079979623026,8.57906194339997,-87,867,MDB
MS,91472,RIO VERDE DE MATO GROSSO,5493,5943,4462,4320,-3.18242940385477,8.19224467504096,-142,450,MDB
MS,91499,ROCHEDO,1603,1787,1399,1386,-0.929235167977127,11.4784778540237,-13,184,PSDB
MS,91570,SIDROLÂNDIA,12603,13497,10845,10740,-0.968188105117562,7.0935491549631,-105,894,PP
MS,91596,TERENOS,4542,5081,4669,4656,-0.278432212465196,11.8670189343901,-13,539,PSDB
MS,91715,ARAL MOREIRA,2962,3232,2812,2627,-6.57894736842105,9.11546252532074,-185,270,PSDB
MS,91731,ELDORADO,3433,3801,2378,2340,-1.59798149705634,10.7194873288669,-38,368,PATRIOTA
MS,91790,MUNDO NOVO,6025,6445,3863,3826,-0.95780481491069,6.97095435684647,-37,420,PSDB
MS,91804,DOIS IRMÃOS DO BURITI,1963,2206,3853,3779,-1.92058136516999,12.3790117167601,-74,243,MDB
MS,91820,JUTI,1793,1939,2084,2016,-3.26295585412668,8.14277746793084,-68,146,PSD
MS,91847,PARANHOS,2346,2388,3419,3295,-3.62679145949107,1.79028132992327,-124,42,
MS,91880,SONORA,4269,4677,3567,3507,-1.68208578637511,9.55727336612791,-60,408,DEM
MS,98019,BODOQUENA,2289,2473,2343,2281,-2.64618011096884,8.03844473569244,-62,184,PSDB
MS,98035,COSTA RICA,8605,9506,6034,5936,-1.62412993039444,10.4706565950029,-98,901,PP
MS,98051,DOURADINA,2222,2362,1553,1552,-0.0643915003219586,6.3006300630063,-1,140,PSDB
MS,98078,ITAQUIRAÍ,4117,4497,5227,5198,-0.554811555385504,9.23002186057809,-29,380,DEM
MS,98094,SÃO GABRIEL DO OESTE,10198,11074,4994,4971,-0.460552663195835,8.58991959207687,-23,876,PSDB
MS,98116,SELVÍRIA,1842,1999,2835,2718,-4.12698412698412,8.52334419109664,-117,157,PSDB
MS,98132,SETE QUEDAS,3136,3369,1967,1906,-3.10116929334011,7.42984693877551,-61,233,PSDB
MS,98159,TACURU,1474,1640,3034,2923,-3.65853658536586,11.2618724559023,-111,166,PATRIOTA
MS,98175,TAQUARUSSU,1131,1253,1516,1461,-3.62796833773087,10.7869142351901,-55,122,PSDB
MS,98590,CORONEL SAPUCAIA,4254,4530,4254,4090,-3.85519511048426,6.48801128349787,-164,276,MDB
MT,89826,NOVA SANTA HELENA,1499,1588,625,608,-2.72,5.93729152768512,-17,89,SOLIDARIEDADE
MT,90018,ACORIZAL,2220,2355,2986,2838,-4.95646349631614,6.08108108108107,-148,135,
MT,90069,QUERÊNCIA,7473,7944,2786,2623,-5.85068198133525,6.3026896828583,-163,471,DEM
MT,90093,ALTO PARAGUAI,1599,1817,2648,2647,-0.0377643504531733,13.6335209505941,-1,218,MDB
MT,90123,NOVA MARINGÁ,2012,2149,875,868,-0.800000000000001,6.80914512922466,-7,137,PATRIOTA
MT,90166,NOVA MARILÂNDIA,1116,1190,779,773,-0.770218228498076,6.63082437275986,-6,74,PP
MT,90239,ARAGUAINHA,314,365,465,416,-10.5376344086021,16.2420382165605,-49,51,PSL
MT,90247,SÃO JOSÉ DO XINGU,1536,1653,1224,1210,-1.1437908496732,7.6171875,-14,117,DEM
MT,90263,APIACÁS,2417,2700,1557,1500,-3.66088631984586,11.7087298303682,-57,283,MDB
MT,90310,BARÃO DE MELGAÇO,1636,1701,3010,2917,-3.08970099667774,3.97310513447433,-93,65,PSDB
MT,90328,SANTO AFONSO,901,990,717,689,-3.90516039051604,9.87791342952276,-28,89,DEM
MT,90549,CASTANHEIRA,2559,2812,1378,1359,-1.37880986937591,9.88667448221963,-19,253,PT
MT,90565,JANGADA,1963,2115,3230,2991,-7.39938080495356,7.74325012735608,-239,152,PP
MT,90743,CAMPOS DE JÚLIO,2602,2833,1103,1059,-3.98912058023572,8.87778631821676,-44,231,PATRIOTA
MT,90786,FELIZ NATAL,2815,3133,1559,1485,-4.74663245670302,11.2966252220249,-74,318,MDB
MT,90840,UNIÃO DO SUL,1416,1567,741,695,-6.20782726045884,10.6638418079096,-46,151,MDB
MT,90867,NOVA LACERDA,1760,1906,1144,1137,-0.611888111888115,8.29545454545455,-7,146,DEM
MT,90883,NOVA UBIRATÃ,3554,3875,1743,1688,-3.15547905909351,9.03207653348339,-55,321,PRTB
MT,90905,BOM JESUS DO ARAGUAIA,1960,2098,1328,1272,-4.21686746987952,7.04081632653062,-56,138,PSB
MT,90921,SERRA NOVA DOURADA,724,747,374,360,-3.74331550802139,3.1767955801105,-14,23,PP
MT,90980,SANTA CRUZ DO XINGU,821,891,419,404,-3.5799522673031,8.52618757612667,-15,70,PSD
MT,91006,CONQUISTA D OESTE,1442,1568,590,581,-1.52542372881356,8.7378640776699,-9,126,PL
MT,91049,SANTA RITA DO TRIVELATO,1032,1104,522,511,-2.10727969348659,6.9767441860465,-11,72,PSD
MT,91057,LUCIARA,836,881,739,730,-1.21786197564276,5.38277511961722,-9,45,MDB
MT,91090,VILA BELA DA SANTÍSSIMA TRINDADE,3863,4157,3252,3140,-3.4440344403444,7.61066528604713,-112,294,MDB
MT,91103,ITANHANGÁ,2922,3185,801,755,-5.74282147315856,9.00068446269677,-46,263,PL
MT,91170,NOBRES,5659,6154,2833,2806,-0.953053300388285,8.7471284679272,-27,495,PSDB
MT,91219,NOSSA SENHORA DO LIVRAMENTO,2782,3081,6339,6260,-1.24625335226376,10.7476635514019,-79,299,DEM
MT,91332,PONTE BRANCA,504,558,843,826,-2.01660735468565,10.7142857142857,-17,54,PODE
MT,91537,ROSÁRIO OESTE,4075,4467,4949,4791,-3.19256415437462,9.6196319018405,-158,392,SOLIDARIEDADE
MT,91553,SANTO ANTÔNIO DO LEVERGER,5343,5830,6753,6651,-1.51043980453132,9.11472955268575,-102,487,PTB
MT,91618,TESOURO,849,931,1075,1002,-6.7906976744186,9.65842167255595,-73,82,PSB
MT,91979,SANTA TEREZINHA,1359,1480,1854,1842,-0.647249190938515,8.90360559234731,-12,121,PSB
MT,98639,ARAGUAIANA,1036,1192,1117,1093,-2.14861235452104,15.0579150579151,-24,156,PSB
MT,98671,COCALINHO,1693,1816,1393,1341,-3.73295046661881,7.26520968694624,-52,123,PSB
MT,98850,PORTO ALEGRE DO NORTE,3165,3418,2195,2176,-0.865603644646928,7.99368088467614,-19,253,PDT
MT,98876,PORTO ESPERIDIÃO,2779,2975,2474,2389,-3.4357316087308,7.05289672544081,-85,196,PSD
MT,99074,INDIAVAÍ,795,829,624,620,-0.641025641025639,4.27672955974843,-4,34,DEM
PA,4006,GOIANÉSIA DO PARÁ,6085,6556,9008,8674,-3.70781527531083,7.74034511092852,-334,471,
PA,4057,AFUÁ,5785,6268,12781,12643,-1.07972772083561,8.34917891097666,-138,483,PSD
PA,4065,SÃO JOÃO DE PIRABAS,3540,3700,9054,8820,-2.5844930417495,4.51977401129944,-234,160,MDB
PA,4081,TUCUMÃ,12354,13145,6862,6801,-0.888953657825709,6.40278452323135,-61,791,PSDB
PA,4090,ALMEIRIM,4798,4855,11781,11451,-2.80112044817927,1.1879949979158,-330,57,MDB
PA,4120,ELDORADO DOS CARAJÁS,6676,7326,7206,7185,-0.291423813488756,9.73636908328341,-21,650,PSD
PA,4146,SANTA LUZIA DO PARÁ,3070,3385,9564,9505,-0.616896695943126,10.2605863192182,-59,315,PSB
PA,4162,PALESTINA DO PARÁ,1687,1774,2651,2580,-2.6782346284421,5.1570835803201,-71,87,PSDB
PA,4197,AVEIRO,2953,2990,4740,4475,-5.59071729957806,1.2529630883847,-265,37,MDB
PA,4235,BAIÃO,4653,4983,15094,14758,-2.22605008612694,7.09219858156029,-336,330,PSD
PA,4286,TRAIRÃO,5348,5541,2722,2599,-4.51873622336517,3.60882572924457,-123,193,PL
PA,4308,PAU D ARCO,2667,2849,2452,2369,-3.38499184339315,6.8241469816273,-83,182,PODE
PA,4324,ULIANÓPOLIS,6704,7150,7409,7222,-2.52395734916993,6.65274463007159,-187,446,
PA,4359,BREVES,17819,18062,32399,30930,-4.53409055835057,1.3637128907346,-1469,243,MDB
PA,4391,CACHOEIRA DO ARARI,2520,2750,10686,10657,-0.271383118098445,9.12698412698412,-29,230,
PA,4405,VITÓRIA DO XINGU,5312,5734,5454,5300,-2.82361569490283,7.94427710843373,-154,422,PSB
PA,4413,CAMETÁ,17289,19273,61121,60945,-0.287953403903729,11.4755046561397,-176,1984,MDB
PA,4421,NOVO REPARTIMENTO,17086,18037,14140,14079,-0.43140028288543,5.56596043544422,-61,951,PSD
PA,4448,BREU BRANCO,8732,9276,12627,12388,-1.8927694622634,6.22995877233166,-239,544,PL
PA,4499,CHAVES,2771,2977,6321,6117,-3.22733744660655,7.43413929989174,-204,206,PTB
PA,4502,ABEL FIGUEIREDO,1563,1768,2377,2357,-0.841396718552801,13.1158029430582,-20,205,PL
PA,4510,COLARES,1864,2028,6411,6219,-2.99485259709874,8.79828326180256,-192,164,MDB
PA,4529,CUMARU DO NORTE,3206,3217,1962,1936,-1.32517838939857,0.343106674984406,-26,11,MDB
PA,4553,CURRALINHO,3556,3766,13871,13465,-2.92696993727921,5.90551181102361,-406,210,PSD
PA,4561,FLORESTA DO ARAGUAIA,5350,5535,4826,4802,-0.497306257770414,3.45794392523364,-24,185,PL
PA,4570,CURUÇÁ,6246,6688,17963,17798,-0.918554807103489,7.07652897854627,-165,442,MDB
PA,4588,BANNACH,1238,1340,848,790,-6.83962264150944,8.23909531502423,-58,102,MDB
PA,4596,FARO,883,942,3988,3772,-5.41624874623872,6.68176670441676,-216,59,PSD
PA,4600,NOVA IPIXUNA,3365,3644,4205,4173,-0.760998810939362,8.29123328380386,-32,279,
PA,4618,GURUPÁ,4414,4565,12035,11516,-4.31242210220191,3.42093339374716,-519,151,MDB
PA,4650,IGARAPÉ-MIRI,13133,14004,25116,25085,-0.123427297340339,6.63214802406154,-31,871,PT
PA,4715,ITAITUBA,34063,35796,21740,21526,-0.984360625574976,5.08763174118545,-214,1733,MDB
PA,4723,ANAPU,9334,9673,6332,6037,-4.65887555274794,3.63188343689735,-295,339,MDB
PA,4731,ITUPIRANGA,8472,9058,14322,13904,-2.91858678955453,6.91690273843248,-418,586,PSD
PA,4740,CURUÁ,1789,1911,6415,6397,-0.280592361652376,6.8194522079374,-18,122,PODE
PA,4758,JACUNDÁ,9627,10431,13309,13198,-0.834022090314823,8.35151137425989,-111,804,PL
PA,4766,CACHOEIRA DO PIRIÁ,2516,2634,7535,7329,-2.73390842733908,4.68998410174881,-206,118,SOLIDARIEDADE
PA,4782,PIÇARRA,3548,3609,3322,3208,-3.43166767007826,1.71927846674182,-114,61,MDB
PA,4820,SÃO JOÃO DA PONTA,1286,1349,3182,3122,-1.88560653676932,4.89891135303266,-60,63,MDB
PA,4847,SAPUCAIA,1576,1691,1913,1769,-7.52744380554104,7.29695431472082,-144,115,MDB
PA,4855,MARACANÃ,5778,5961,13482,13178,-2.25485832962469,3.16718587746625,-304,183,PL
PA,4871,MARAPANIM,5348,5642,12018,11646,-3.09535696455318,5.49738219895288,-372,294,MDB
PA,4910,MOCAJUBA,4909,5320,15487,15451,-0.23245302511784,8.37237726624567,-36,411,MDB
PA,4979,MUANÁ,4758,4999,15710,15680,-0.190961171228521,5.06515342580916,-30,241,PSC
PA,5037,OEIRAS DO PARÁ,3321,3587,14713,14518,-1.32535852647319,8.00963565191209,-195,266,PMN
PA,5053,ORIXIMINÁ,13572,14432,19850,19101,-3.77329974811084,6.33657530209255,-749,860,PRTB
PA,5096,PARAGOMINAS,29708,32193,22360,22155,-0.916815742397137,8.36475023562677,-205,2485,PSD
PA,5134,PONTA DE PEDRAS,3667,4140,12296,12129,-1.35816525699415,12.8988273793291,-167,473,PSD
PA,5150,PORTEL,7865,8354,16823,16351,-2.80568269630862,6.21741894469168,-472,489,MDB
PA,5177,PORTO DE MOZ,5361,5928,10943,9949,-9.08343233117062,10.576385002798,-994,567,PTB
PA,5193,PRAINHA,7946,8220,11278,11140,-1.2236212094343,3.44827586206897,-138,274,MDB
PA,5274,SANTA CRUZ DO ARARI,1161,1177,3200,3063,-4.28125,1.37812230835486,-137,16,MDB
PA,5339,SANTANA DO ARAGUAIA,9876,10661,6172,5979,-3.12702527543746,7.94856217091939,-193,785,MDB
PA,5371,SANTARÉM NOVO,1159,1206,3767,3631,-3.61029997345368,4.05522001725624,-136,47,PL
PA,5410,SÃO CAETANO DE ODIVELAS,2713,2879,8478,8383,-1.12054729889125,6.11868779948397,-95,166,DEM
PA,5495,SÃO JOÃO DO ARAGUAIA,3086,3268,5024,4962,-1.23407643312102,5.89760207388206,-62,182,PDT
PA,5533,SÃO SEBASTIÃO DA BOA VISTA,3944,3965,12744,12481,-2.06371625863151,0.532454361054757,-263,21,PL
PA,5550,SENADOR JOSÉ PORFÍRIO,4068,4306,4881,4734,-3.01167793484942,5.85054080629301,-147,238,PSC
PA,5576,SOURE,3498,3667,12101,11923,-1.47095281381704,4.83133218982275,-178,169,PL
PA,5614,TUCURUÍ,20907,22909,29837,29792,-0.150819452357809,9.57574018271392,-45,2002,MDB
PA,5657,VISEU,5763,6140,25546,25514,-0.125264229233535,6.54173173694257,-32,377,PL
PA,5673,REDENÇÃO,30037,32790,14587,14569,-0.123397545759918,9.16536271931285,-18,2753,PSD
PA,5690,RIO MARIA,5618,6088,4344,4303,-0.943830570902393,8.36596653613386,-41,470,MDB
PA,5797,SÃO GERALDO DO ARAGUAIA,7831,8116,6403,6252,-2.35826956114321,3.63938194355766,-151,285,PTB
PA,5916,PACAJÁ,11511,12112,8162,8039,-1.50698358245528,5.22109286769177,-123,601,PSC
PA,5932,BREJO GRANDE DO ARAGUAIA,2035,2130,2898,2811,-3.00207039337475,4.66830466830468,-87,95,PDT
PA,5959,OURILÂNDIA DO NORTE,9605,10144,6496,6435,-0.939039408866993,5.61166059344092,-61,539,AVANTE
PA,5975,DOM ELISEU,9705,10883,11863,11698,-1.39087920424851,12.1380731581659,-165,1178,PSDB
PA,5991,SANTA MARIA DAS BARREIRAS,5338,5548,3467,3373,-2.71127776175367,3.93405769951292,-94,210,MDB
PB,19038,AGUIAR,571,621,2965,2946,-0.640809443507584,8.75656742556918,-19,50,PTB
PB,19291,BAÍA DA TRAIÇÃO,892,974,4775,4760,-0.314136125654452,9.19282511210762,-15,82,DEM
PB,19321,ASSUNÇÃO,638,680,2379,2365,-0.588482555695669,6.58307210031348,-14,42,PTB
PB,19330,BARRA DE SANTA ROSA,1367,1683,6603,6568,-0.530062092988037,23.1163130943672,-35,316,DEM
PB,19364,CACIMBAS,513,578,3693,3667,-0.704034660167885,12.6705653021443,-26,65,PSDB
PB,19410,BELÉM DO BREJO DO CRUZ,1077,1147,3502,3472,-0.856653340948033,6.49953574744662,-30,70,PL
PB,19437,BOA VENTURA,587,665,3060,3024,-1.17647058823529,13.2879045996593,-36,78,REPUBLICANOS
PB,19445,SÃO JOSÉ DE PRINCESA,229,371,2131,2044,-4.08259033317692,62.0087336244541,-87,142,PP
PB,19488,MATO GROSSO,176,204,1969,1946,-1.16810563737938,15.9090909090909,-23,28,REPUBLICANOS
PB,19534,IGARACY,662,735,3172,3147,-0.788146279949553,11.0271903323263,-25,73,PTB
PB,19542,SÃO JOSÉ DO BREJO DO CRUZ,429,515,1273,1236,-2.90652003142183,20.0466200466201,-37,86,PL
PB,19682,TENÓRIO,382,394,1846,1828,-0.975081256771393,3.1413612565445,-18,12,REPUBLICANOS
PB,19771,CALDAS BRANDÃO,869,965,3136,3130,-0.191326530612246,11.0471806674338,-6,96,MDB
PB,19828,RIACHO DE SANTO ANTÔNIO,537,583,1360,1355,-0.367647058823528,8.56610800744879,-5,46,PROS
PB,19852,CATINGUEIRA,821,891,2842,2813,-1.02040816326531,8.52618757612667,-29,70,DEM
PB,19909,AREIA DE BARAÚNAS,238,247,1378,1374,-0.290275761973879,3.78151260504203,-4,9,PROS
PB,19950,CONGO,655,722,3395,3385,-0.294550810014727,10.2290076335878,-10,67,PSB
PB,20095,DESTERRO,946,1033,4426,4419,-0.158156348847716,9.19661733615222,-7,87,REPUBLICANOS
PB,20133,DIAMANTE,651,684,3144,3123,-0.667938931297707,5.06912442396312,-21,33,PODE
PB,20630,LAGOA,461,496,2933,2905,-0.954653937947492,7.59219088937093,-28,35,REPUBLICANOS
PB,20699,LASTRO,493,518,2755,2754,-0.0362976406533599,5.0709939148073,-1,25,CIDADANIA
PB,20737,LUCENA,2885,3106,6128,6063,-1.06070496083551,7.66031195840555,-65,221,SOLIDARIEDADE
PB,21393,PITIMBU,2729,2913,6382,6366,-0.250705108116578,6.74239648222792,-16,184,PDT
PB,21458,PRATA,744,812,2310,2297,-0.562770562770565,9.13978494623655,-13,68,CIDADANIA
PB,21610,SALGADINHO,449,454,1841,1826,-0.81477457903314,1.11358574610245,-15,5,PSDB
PB,21792,SÃO BENTO,8358,9122,11629,11388,-2.07240519391178,9.14094280928452,-241,764,CIDADANIA
PB,22390,UIRAÚNA,1607,1821,7562,7524,-0.502512562814073,13.3167392657125,-38,214,PP
PB,22438,VÁRZEA,300,340,1773,1765,-0.451212633953746,13.3333333333333,-8,40,DEM
PE,23167,CARNAUBEIRA DA PENHA,615,663,7994,7945,-0.612959719789841,7.8048780487805,-49,48,MDB
PE,23256,BARRA DE GUABIRABA,2618,2800,5025,4921,-2.06965174129353,6.95187165775402,-104,182,MDB
PE,23299,BELÉM DE MARIA,1671,1792,5315,5248,-1.26058325493885,7.24117295032913,-67,121,REPUBLICANOS
PE,23310,BELÉM DO SÃO FRANCISCO,1590,1774,9731,9609,-1.25372520809783,11.5723270440252,-122,184,MDB
PE,23353,BETÂNIA,721,759,6128,5988,-2.28459530026109,5.27045769764216,-140,38,REPUBLICANOS
PE,23736,CANHOTINHO,3208,3499,9041,9021,-0.221214467426167,9.07107231920199,-20,291,DEM
PE,23850,CEDRO,735,799,6160,5956,-3.31168831168831,8.70748299319728,-204,64,MDB
PE,24139,FLORESTA,2351,2519,15262,15151,-0.727296553531642,7.14589536367503,-111,168,PSB
PE,24317,IBIMIRIM,1474,1624,13032,12969,-0.483425414364636,10.1763907734057,-63,150,PC do B
PE,24392,INAJÁ,940,1021,9507,9502,-0.0525928263384823,8.61702127659574,-5,81,PSD
PE,24473,ITACURUBA,411,412,2965,2829,-4.58684654300169,0.243309002433101,-136,1,MDB
PE,24554,ITAQUITINGA,2961,3170,6934,6867,-0.9662532448803,7.05842620736237,-67,209,PSD
PE,24830,MARAIAL,1595,1639,4229,4040,-4.46914164104989,2.75862068965518,-189,44,AVANTE
PE,24953,OROCÓ,1534,1708,7378,7303,-1.01653564651667,11.3428943937419,-75,174,PT
PE,25038,PANELAS,2984,3306,11148,11117,-0.278076785073556,10.7908847184987,-31,322,PSB
PE,25070,PARNAMIRIM,1200,1301,12525,12468,-0.455089820359278,8.41666666666667,-57,101,PSB
PE,25178,PESQUEIRA,5448,6157,29993,29564,-1.43033374454039,13.0139500734214,-429,709,
PE,25194,PETROLÂNDIA,3178,3493,15010,14965,-0.299800133244499,9.91189427312775,-45,315,PTB
PE,25518,SANTA MARIA DA BOA VISTA,3481,3911,18836,18803,-0.175196432363556,12.3527721918989,-33,430,PP
PE,25674,SÃO JOSÉ DA COROA GRANDE,4567,4714,6724,6524,-2.97441998810232,3.21874315743376,-200,147,CIDADANIA
PE,25798,SERRITA,1023,1202,10252,10220,-0.312134217713622,17.4975562072336,-32,179,MDB
PE,25810,SERTÂNIA,2362,2573,15521,15461,-0.386573030088266,8.93310753598646,-60,211,PSB
PE,30015,FERNANDO DE NORONHA,902,922,1140,1068,-6.31578947368421,2.21729490022173,-72,20,
PI,10022,ALEGRETE DO PIAUÍ,587,636,2665,2584,-3.03939962476548,8.34752981260647,-81,49,PT
PI,10030,ÁGUA BRANCA,3041,3351,8835,8576,-2.93152235427278,10.1940151266031,-259,310,PSD
PI,10065,BOM PRINCÍPIO DO PIAUÍ,908,1023,3850,3789,-1.58441558441559,12.6651982378855,-61,115,DC
PI,10090,AMARANTE,1537,1834,9683,9530,-1.58008881544975,19.3233571893299,-153,297,PP
PI,10103,BURITI DOS MONTES,533,633,4640,4606,-0.732758620689655,18.7617260787992,-34,100,MDB
PI,10154,ANTÔNIO ALMEIDA,586,648,1626,1596,-1.8450184501845,10.580204778157,-30,62,PSB
PI,10162,CANAVIEIRA,348,374,2136,2074,-2.90262172284644,7.47126436781609,-62,26,PT
PI,10170,AROAZES,564,570,3618,3544,-2.04532891100055,1.06382978723405,-74,6,PTB
PI,10189,COIVARAS,706,805,3435,3386,-1.42649199417758,14.0226628895184,-49,99,PT
PI,10251,BARREIRAS DO PIAUÍ,450,475,1987,1971,-0.805234021137391,5.55555555555556,-16,25,PT
PI,10260,FARTURA DO PIAUÍ,229,264,3310,3266,-1.32930513595166,15.2838427947598,-44,35,REPUBLICANOS
PI,10308,JARDIM DO MULATO,601,704,2655,2598,-2.14689265536723,17.1381031613977,-57,103,PP
PI,10324,LAGOA ALEGRE,744,845,5495,5478,-0.309372156505916,13.5752688172043,-17,101,MDB
PI,10332,BERTOLÍNIA,739,933,2740,2609,-4.78102189781022,26.2516914749662,-131,194,REPUBLICANOS
PI,10359,BOCAINA,807,942,3438,3307,-3.81035485747527,16.728624535316,-131,135,PP
PI,10405,PASSAGEM FRANCA DO PIAUÍ,601,623,2219,2141,-3.51509689049121,3.66056572379367,-78,22,PSDB
PI,10448,SANTA CRUZ DOS MILAGRES,379,402,2143,2107,-1.67988800746617,6.06860158311346,-36,23,PP
PI,10529,SÃO JOSÉ DO DIVINO,501,610,3328,3308,-0.600961538461542,21.7564870259481,-20,109,MDB
PI,10545,SIGEFREDO PACHECO,967,1039,5811,5755,-0.963689554293579,7.44570837642193,-56,72,PP
PI,10618,CRISTINO CASTRO,1026,1115,4773,4748,-0.523779593547036,8.67446393762183,-25,89,PT
PI,10634,CURIMATÁ,1456,1786,5095,5068,-0.529931305201181,22.6648351648352,-27,330,PP
PI,10685,DOM INOCÊNCIO,447,562,5273,5252,-0.398255262658831,25.7270693512304,-21,115,PP
PI,10693,ELESBÃO VELOSO,1100,1370,7974,7845,-1.61775771256584,24.5454545454545,-129,270,PP
PI,10766,CURRAIS,644,693,3492,3470,-0.630011454753721,7.6086956521739,-22,49,PP
PI,10804,GUARIBAS,180,193,2966,2949,-0.573162508428859,7.22222222222222,-17,13,MDB
PI,10812,FRANCISCO AYRES,440,510,2863,2857,-0.209570380719526,15.9090909090909,-6,70,REPUBLICANOS
PI,10855,FRONTEIRAS,1276,1381,5857,5704,-2.61225883558136,8.22884012539184,-153,105,PSD
PI,10880,MORRO CABEÇA NO TEMPO,392,554,2225,2131,-4.2247191011236,41.3265306122449,-94,162,PP
PI,10901,NOVO SANTO ANTÔNIO,394,414,3086,3005,-2.62475696694751,5.07614213197969,-81,20,PT
PI,10910,HUGO NAPOLEÃO,544,574,2701,2554,-5.44242873009997,5.51470588235294,-147,30,PT
PI,10944,PAQUETÁ,454,544,2716,2676,-1.47275405007363,19.8237885462555,-40,90,PP
PI,10960,NOVA SANTA RITA,222,254,2942,2934,-0.271923861318835,14.4144144144144,-8,32,PP
PI,11053,JERUMENHA,604,654,2867,2788,-2.75549354726194,8.27814569536425,-79,50,PL
PI,11088,SÃO JOÃO DA CANABRAVA,422,479,3242,3171,-2.19000616903147,13.5071090047393,-71,57,MDB
PI,11118,LANDRI SALES,432,507,2846,2828,-0.632466619817285,17.3611111111111,-18,75,PP
PI,11150,LUZILÂNDIA,2907,3183,11578,11551,-0.233200898255315,9.49432404540764,-27,276,PTB
PI,11177,MANOEL EMÍDIO,462,527,3011,2985,-0.863500498173364,14.0692640692641,-26,65,MDB
PI,11193,MARCOS PARENTE,773,834,2174,2168,-0.275988960441587,7.89133247089262,-6,61,MDB
PI,11258,MIGUEL LEÃO,350,467,903,767,-15.0609080841639,33.4285714285714,-136,117,PP
PI,11274,MONSENHOR GIL,1302,1492,6545,6538,-0.106951871657757,14.5929339477727,-7,190,PSD
PI,11355,NOSSA SENHORA DOS REMÉDIOS,1106,1267,5151,5058,-1.80547466511357,14.5569620253165,-93,161,PSD
PI,11495,PALMEIRAIS,1214,1279,8267,8211,-0.677392040643521,5.35420098846788,-56,65,PTB
PI,11690,PORTO,1207,1527,5291,4930,-6.82290682290683,26.5120132560066,-361,320,PP
PI,11770,RIBEIRO GONÇALVES,876,989,3063,2979,-2.74240940254652,12.8995433789954,-84,113,PT
PI,11819,SANTA CRUZ DO PIAUÍ,518,628,3770,3709,-1.61803713527852,21.2355212355212,-61,110,PTB
PI,11835,SANTA FILOMENA,853,1036,2961,2927,-1.14826072272881,21.4536928487691,-34,183,PP
PI,11878,SANTO ANTÔNIO DE LISBOA,793,1031,3698,3617,-2.19037317468902,30.0126103404792,-81,238,PP
PI,11894,SANTO INÁCIO DO PIAUÍ,344,360,2330,2263,-2.87553648068669,4.65116279069768,-67,16,REPUBLICANOS
PI,11916,SÃO FÉLIX DO PIAUÍ,566,712,2163,1953,-9.70873786407767,25.7950530035336,-210,146,PP
PI,11932,SÃO FRANCISCO DO PIAUÍ,1090,1227,3104,3074,-0.966494845360821,12.5688073394495,-30,137,PP
PI,11975,SÃO JOÃO DA SERRA,782,856,4026,4008,-0.447093889716843,9.46291560102301,-18,74,PDT
PI,12009,SÃO JOÃO DA FRONTEIRA,539,652,3127,3039,-2.81419891269588,20.9647495361781,-88,113,PP
PI,12017,SÃO JOSÉ DO PEIXE,303,319,1983,1943,-2.01714573877962,5.28052805280528,-40,16,PP
PI,12025,SÃO JOÃO DA VARJOTA,422,533,2530,2454,-3.00395256916997,26.303317535545,-76,111,PP
PI,12050,SÃO JULIÃO,1170,1227,2885,2860,-0.866551126516468,4.87179487179488,-25,57,PSB
PI,12084,ALVORADA DO GURGUÉIA,545,631,2826,2823,-0.106157112526539,15.7798165137615,-3,86,MDB
PI,12157,SIMPLÍCIO MENDES,1030,1241,6451,6432,-0.29452798015811,20.4854368932039,-19,211,PSD
PI,12165,CARIDADE DO PIAUÍ,355,383,3257,3133,-3.80718452563709,7.88732394366196,-124,28,PSD
PI,12173,SOCORRO DO PIAUÍ,510,513,2523,2465,-2.29885057471264,0.588235294117645,-58,3,MDB
PI,12300,RIACHO FRIO,299,340,2846,2832,-0.491918482080112,13.7123745819398,-14,41,PP
PI,12343,CAJAZEIRAS DO PIAUÍ,313,368,2280,2203,-3.37719298245615,17.5718849840256,-77,55,PP
PI,12394,JATOBÁ DO PIAUÍ,643,733,4332,4294,-0.877192982456143,13.9968895800933,-38,90,PSD
PI,12408,JOCA MARQUES,563,683,3035,2982,-1.74629324546952,21.3143872113677,-53,120,MDB
PI,12416,JUAZEIRO DO PIAUÍ,693,759,3458,3420,-1.0989010989011,9.52380952380953,-38,66,
PI,12432,LAGOINHA DO PIAUÍ,368,421,1965,1960,-0.254452926208648,14.4021739130435,-5,53,PTB
PI,12491,PEDRO LAURENTINO,638,654,1552,1543,-0.579896907216493,2.5078369905956,-9,16,PP
PI,12548,VILA NOVA DO PIAUÍ,369,414,1873,1849,-1.281366791244,12.1951219512195,-24,45,PSD
PI,12564,WALL FERRAZ,574,675,2665,2576,-3.33958724202627,17.595818815331,-89,101,PP
PI,12580,CURRALINHOS,484,523,3390,3344,-1.35693215339233,8.05785123966942,-46,39,MDB
PI,12599,PORTO ALEGRE DO PIAUÍ,279,312,1209,1204,-0.413564929693966,11.8279569892473,-5,33,MDB
PI,12629,SÃO LUIS DO PIAUÍ,267,375,1908,1831,-4.0356394129979,40.4494382022472,-77,108,PP
PI,12653,SANTO ANTÔNIO DOS MILAGRES,216,244,1262,1223,-3.09033280507132,12.962962962963,-39,28,PSD
PR,74055,AGUDOS DO SUL,3608,4051,2377,2343,-1.43037442153976,12.2782705099778,-34,443,
PR,74160,BOM SUCESSO DO SUL,1428,1558,914,901,-1.42231947483589,9.10364145658262,-13,130,PSDB
PR,74209,CAFEZAL DO SUL,1759,1986,1234,1222,-0.972447325769854,12.9050596930074,-12,227,PSB
PR,74241,CRUZEIRO DO IGUAÇU,1194,1323,1598,1543,-3.44180225281602,10.8040201005025,-55,129,PSDB
PR,74268,DIAMANTE DO SUL,1137,1178,1201,1181,-1.66527893422148,3.60598065083553,-20,41,PSB
PR,74284,ENTRE RIOS DO OESTE,2159,2240,771,768,-0.389105058365757,3.75173691523854,-3,81,PSD
PR,74365,HONÓRIO SERPA,1284,1436,2060,2034,-1.2621359223301,11.8380062305296,-26,152,PSC
PR,74403,IRACEMA DO OESTE,826,952,923,916,-0.758396533044425,15.2542372881356,-7,126,PP
PR,74543,MAUÁ DA SERRA,3074,3373,2340,2292,-2.05128205128206,9.72674040338322,-48,299,PSD
PR,74551,BITURUNA,3737,4306,5378,5366,-0.223131275567123,15.2261172063152,-12,569,PSDB
PR,74748,RIO BONITO DO IGUAÇU,2485,2699,6039,5869,-2.81503560192085,8.61167002012073,-170,214,PDT
PR,74888,TUNAS DO PARANÁ,1848,2109,1943,1942,-0.0514668039114818,14.1233766233766,-1,261,PP
PR,74926,ALTO PARAÍSO,1138,1293,935,908,-2.88770053475936,13.6203866432338,-27,155,PSD
PR,74985,LARANJAL,1068,1187,2344,2326,-0.767918088737196,11.1423220973783,-18,119,PL
PR,75060,SAUDADE DO IGUAÇU,1638,1827,2344,2334,-0.426621160409557,11.5384615384615,-10,189,PSD
PR,75108,ARAPUÃ,1045,1222,1349,1344,-0.370644922164565,16.9377990430622,-5,177,MDB
PR,75116,MANGUEIRINHA,4459,5130,5683,5604,-1.39011085694175,15.0482170890334,-79,671,PSDB
PR,75167,BOM JESUS DO SUL,1165,1361,1658,1553,-6.33293124246079,16.8240343347639,-105,196,PP
PR,75248,CORONEL DOMINGOS SOARES,1356,1528,2383,2377,-0.251783466219047,12.6843657817109,-6,172,PT
PR,75345,FERNANDES PINHEIRO,1912,2315,2116,2072,-2.07939508506616,21.0774058577406,-44,403,PSD
PR,75361,FOZ DO JORDÃO,1079,1170,2098,2059,-1.85891325071497,8.43373493975903,-39,91,PSB
PR,75388,GOIOXIM,1267,1475,2666,2635,-1.16279069767442,16.4167324388319,-31,208,MDB
PR,75469,MANFRINÓPOLIS,712,778,1609,1569,-2.48601615910503,9.26966292134832,-40,66,PSC
PR,75485,MARQUINHO,1171,1273,1727,1716,-0.636942675159236,8.71050384286933,-11,102,PODE
PR,75540,PORTO BARREIRO,1085,1188,1349,1306,-3.18754633061527,9.4930875576037,-43,103,PL
PR,75647,SERRANÓPOLIS DO IGUAÇU,2403,2590,1012,1001,-1.08695652173914,7.78193924261339,-11,187,PDT
PR,75671,GENERAL CARNEIRO,2676,3101,3472,3452,-0.576036866359442,15.881913303438,-20,425,PSDB
PR,75710,GUAÍRA,11413,12496,5649,5627,-0.389449460081426,9.48917900639621,-22,1083,DEM
PR,75736,GUAIRAÇÁ,2089,2381,1689,1673,-0.947306098283007,13.9779798946865,-16,292,PP
PR,75850,GUARAQUEÇABA,2593,2765,2299,2271,-1.21792083514571,6.63324334747397,-28,172,PSC
PR,76015,INAJÁ,646,738,1127,1110,-1.50842945874001,14.2414860681115,-17,92,PSD
PR,76970,MARUMBI,1412,1599,1530,1525,-0.326797385620914,13.2436260623229,-5,187,PSD
PR,77038,MIRADOR,548,596,1022,1011,-1.07632093933464,8.75912408759123,-11,48,PSD
PR,77151,NOVA ALIANÇA DO IVAÍ,529,610,589,569,-3.3955857385399,15.3119092627599,-20,81,PSB
PR,77178,NOVA AMÉRICA DA COLINA,1223,1375,1184,1154,-2.53378378378378,12.4284546197874,-30,152,PSD
PR,77836,PORTO RICO,1206,1322,820,796,-2.92682926829269,9.61857379767828,-24,116,PSD
PR,78379,SALTO DO LONTRA,3047,3463,5562,5557,-0.0898957209636841,13.6527732195602,-5,416,PDT
PR,78573,SANTO ANTÔNIO DO SUDOESTE,5465,6124,6056,5984,-1.1889035667107,12.0585544373285,-72,659,PL
PR,78654,SANTO INÁCIO,1688,1832,1875,1862,-0.693333333333335,8.53080568720379,-13,144,PV
PR,78816,SÃO JORGE D OESTE,3277,3688,3006,2955,-1.69660678642715,12.5419591089411,-51,411,PSC
PR,79553,QUEDAS DO IGUAÇU,9992,10962,7261,7106,-2.13469219115824,9.70776621297038,-155,970,PSD
PR,79790,NOVA SANTA ROSA,4804,5062,867,843,-2.7681660899654,5.37052456286429,-24,258,MDB
PR,79871,TRÊS BARRAS DO PARANÁ,3858,4217,3094,3072,-0.71105365223012,9.30533955417314,-22,359,PL
PR,84654,DOURADINA,3083,3536,1898,1878,-1.05374077976818,14.6934803762569,-20,453,PSL
RJ,59056,SÃO SEBASTIÃO DO ALTO,3025,3251,2690,2677,-0.483271375464689,7.4710743801653,-13,226,SOLIDARIEDADE
RN,16047,CAIÇARA DO NORTE,1184,1308,2746,2695,-1.85724690458849,10.472972972973,-51,124,PSDB
RN,16055,AFONSO BEZERRA,1884,1942,5383,5344,-0.724503065205273,3.07855626326965,-39,58,PT
RN,16098,ALEXANDRIA,1129,1292,7344,7312,-0.435729847494548,14.4375553587245,-32,163,PSD
RN,16110,ALMINO AFONSO,652,676,3318,3289,-0.874020494273664,3.68098159509203,-29,24,MDB
RN,16128,TRIUNFO POTIGUAR,859,898,2244,2240,-0.178253119429594,4.54016298020954,-4,39,PP
RN,16144,FERNANDO PEDROZA,663,669,1793,1778,-0.836586726157274,0.904977375565608,-15,6,MDB
RN,16179,ANTÔNIO MARTINS,602,621,3915,3892,-0.5874840357599,3.15614617940199,-23,19,PSD
RN,16268,RIO DO FOGO,2813,2993,4766,4680,-1.80444817456987,6.39886242445789,-86,180,DEM
RN,16373,CAIÇARA DO RIO DO VENTO,714,731,2200,2169,-1.4090909090909,2.38095238095237,-31,17,REPUBLICANOS
RN,16993,JANDAÍRA,1151,1236,3289,3269,-0.608087564609305,7.38488271068636,-20,85,MDB
RN,17019,JANDUÍS,579,628,2802,2795,-0.249821556031404,8.4628670120898,-7,49,PSOL
RN,17078,JARDIM DE ANGICOS,450,464,1785,1736,-2.74509803921569,3.11111111111111,-49,14,DEM
RN,17159,JOÃO DIAS,368,376,1887,1672,-11.3937466878643,2.17391304347827,-215,8,PP
RN,17213,MESSIAS TARGINO,884,1063,2687,2528,-5.91737997767027,20.2488687782805,-159,179,PL
RN,17493,MAXARANGUAPE,2139,2449,4925,4883,-0.852791878172587,14.4927536231884,-42,310,PSDB
RN,17515,FRUTUOSO GOMES,475,529,2653,2634,-0.716170373162461,11.3684210526316,-19,54,MDB
RN,17736,PARAÚ,811,851,2515,2431,-3.33996023856858,4.93218249075216,-84,40,PP
RN,17892,PEDRA GRANDE,695,743,2405,2290,-4.78170478170478,6.90647482014388,-115,48,PSDB
RN,17914,PEDRA PRETA,680,704,1802,1733,-3.82907880133185,3.52941176470589,-69,24,PP
RN,17930,PEDRO AVELINO,1058,1149,3395,3319,-2.23858615611193,8.60113421550095,-76,91,MDB
RN,17990,PILÕES,294,318,2345,2339,-0.255863539445633,8.16326530612246,-6,24,MDB
RN,18112,RIACHO DA CRUZ,362,563,1811,1665,-8.06184428492546,55.5248618784531,-146,201,PP
RN,18198,RUY BARBOSA,1304,1391,1701,1613,-5.17342739564962,6.67177914110428,-88,87,PSDB
RN,18317,SÃO BENTO DO NORTE,617,677,2198,2188,-0.454959053685167,9.72447325769854,-10,60,PSD
RN,18732,TABOLEIRO GRANDE,500,536,1743,1714,-1.66379804934022,7.20000000000001,-29,36,PSD
RN,18791,TENENTE ANANIAS,1280,1351,4700,4674,-0.553191489361704,5.546875,-26,71,PSD
RN,18830,TIMBAÚBA DOS BATISTAS,562,686,1424,1404,-1.40449438202247,22.0640569395018,-20,124,PL
RN,18910,VÁRZEA,1202,1338,2540,2523,-0.669291338582678,11.3144758735441,-17,136,MDB
RN,18937,RAFAEL GODEIRO,958,1103,1767,1714,-2.99943406904357,15.1356993736952,-53,145,MDB
RO,19,GUAJARÁ-MIRIM,12157,13001,7028,6838,-2.7034718269778,6.94250226207123,-190,844,MDB
RO,78,ARIQUEMES,36941,39901,10539,10513,-0.246702723218517,8.01277713110093,-26,2960,PATRIOTA
RO,159,JARU,20725,22611,6846,6813,-0.482033304119189,9.10012062726175,-33,1886,PSDB
RO,213,COSTA MARQUES,3883,4220,2551,2425,-4.93923951391612,8.67885655421066,-126,337,REPUBLICANOS
RO,256,ESPIGÃO DO OESTE,12531,13595,4277,4212,-1.51975683890577,8.49094246269253,-65,1064,PODE
RO,310,ALTA FLORESTA D OESTE,9034,9768,3976,3959,-0.427565392354123,8.12486163382775,-17,734,PODE
RO,434,NOVA MAMORÉ,9627,10226,3037,2897,-4.60981231478432,6.22208372286279,-140,599,DEM
RO,450,CABIXI,2206,2405,1136,1106,-2.64084507042254,9.02085222121487,-30,199,PP
RO,477,CANDEIAS DO JAMARI,7449,8101,5124,4887,-4.62529274004684,8.75285273191033,-237,652,PATRIOTA
RO,493,ITAPUÃ DO OESTE,2481,2736,1707,1642,-3.80785002929115,10.2781136638452,-65,255,MDB
RO,515,NOVO HORIZONTE DO OESTE,3127,3422,1853,1849,-0.21586616297895,9.43396226415094,-4,295,MDB
RO,531,CASTANHEIRAS,1236,1356,887,862,-2.8184892897407,9.70873786407767,-25,120,PP
RO,590,THEOBROMA,3519,3816,1785,1784,-0.0560224089635852,8.43989769820972,-1,297,PSD
RO,612,GOVERNADOR JORGE TEIXEIRA,3415,3625,1543,1540,-0.194426441996109,6.1493411420205,-3,210,PP
RO,620,CACAULÂNDIA,2046,2210,723,692,-4.28769017980636,8.01564027370478,-31,164,DEM
RO,639,ALTO PARAÍSO,6020,6410,2042,1995,-2.30166503428012,6.47840531561461,-47,390,DEM
RO,647,RIO CRESPO,1640,1752,599,590,-1.50250417362271,6.82926829268293,-9,112,PSD
RO,663,MONTE NEGRO,4969,5308,1816,1763,-2.91850220264317,6.82229824914469,-53,339,PSD
RO,680,CUJUBIM,5603,5818,1810,1729,-4.47513812154696,3.8372300553275,-81,215,DEM
RO,701,PARECIS,1346,1405,957,904,-5.53814002089864,4.38335809806836,-53,59,PSB
RO,728,PRIMAVERA DE RONDÔNIA,1486,1630,581,559,-3.78657487091222,9.69044414535667,-22,144,REPUBLICANOS
RO,752,TEIXEIRÓPOLIS,1746,1888,1106,1100,-0.542495479204341,8.13287514318441,-6,142,PT
RO,787,PIMENTEIRAS DO OESTE,902,943,502,495,-1.39442231075697,4.54545454545454,-7,41,PP
RO,795,SÃO FRANCISCO DO GUAPORÉ,6162,6530,2633,2574,-2.24078997341436,5.97208698474521,-59,368,MDB
RO,809,CHUPINGUAIA,3137,3352,1683,1586,-5.76351752822341,6.85368186165125,-97,215,DEM
RS,84794,SÃO JORGE,1507,1707,443,434,-2.03160270880361,13.271400132714,-9,200,MDB
RS,84816,NOVA HARTZ,6476,7367,4634,4602,-0.690548122572288,13.7584928968499,-32,891,PP
RS,84840,TUNAS,864,996,1703,1690,-0.763358778625956,15.2777777777778,-13,132,PTB
RS,84875,QUINZE DE NOVEMBRO,1848,2113,890,881,-1.01123595505618,14.3398268398268,-9,265,MDB
RS,84883,DOUTOR MAURÍCIO CARDOSO,1937,2103,1166,1141,-2.14408233276158,8.56995353639649,-25,166,PP
RS,84921,BOQUEIRÃO DO LEÃO,2086,2455,2056,2032,-1.16731517509727,17.6893576222435,-24,369,PL
RS,84948,ÁGUA SANTA,1601,1868,859,815,-5.12223515715948,16.6770768269831,-44,267,MDB
RS,84964,IBIRAPUITÃ,1388,1580,1309,1299,-0.763941940412527,13.8328530259366,-10,192,MDB
RS,84972,IBARAMA,1276,1529,1393,1378,-1.07681263460158,19.8275862068966,-15,253,MDB
RS,84980,PANTANO GRANDE,2225,2643,3814,3725,-2.33350812794966,18.7865168539326,-89,418,PTB
RS,85006,TRINDADE DO SUL,1736,2029,2226,2204,-0.988319856244379,16.8778801843318,-22,293,PT
RS,85081,EREBANGO,1078,1249,834,803,-3.71702637889688,15.8627087198516,-31,171,MDB
RS,85146,PAVERAMA,2526,2788,1895,1858,-1.95250659630607,10.3721298495645,-37,262,PSB
RS,85260,LAGOÃO,1029,1241,2392,2374,-0.752508361204018,20.6025267249757,-18,212,PDT
RS,85456,BOM JESUS,2740,3260,3086,3048,-1.23136746597537,18.978102189781,-38,520,MDB
RS,85464,CRISTAL,2153,2491,2397,2275,-5.08969545264915,15.6990246168137,-122,338,PSDB
RS,85472,BOM RETIRO DO SUL,4563,4991,2831,2830,-0.0353232073472265,9.37979399517861,-1,428,PL
RS,85480,SÃO MIGUEL DAS MISSÕES,1986,2226,2488,2458,-1.20578778135049,12.0845921450151,-30,240,PP
RS,85510,BRAGA,787,877,1354,1304,-3.69276218611522,11.43583227446,-50,90,MDB
RS,85570,CACEQUI,2573,2897,3569,3528,-1.14878117119641,12.5923047026817,-41,324,MDB
RS,85588,SÃO JOSÉ DO HERVAL,637,729,803,785,-2.24159402241594,14.4427001569859,-18,92,PDT
RS,85600,VISTA ALEGRE,831,947,1174,1155,-1.61839863713799,13.9590854392298,-19,116,PT
RS,85634,CACIQUE DOBLE,1772,1998,1306,1290,-1.22511485451761,12.7539503386005,-16,226,PDT
RS,85715,CAMBARÁ DO SUL,2318,2580,1343,1340,-0.223380491437086,11.3028472821398,-3,262,MDB
RS,85723,TUPANDI,2560,2862,801,768,-4.11985018726592,11.796875,-33,302,PTB
RS,85790,CAMPO NOVO,1411,1535,1634,1622,-0.734394124847004,8.78809355067327,-12,124,PSB
RS,85812,CANDELÁRIA,9158,10324,7320,7249,-0.96994535519126,12.7320375627866,-71,1166,PSB
RS,85901,ITACURUBI,847,1008,1042,1035,-0.671785028790783,19.0082644628099,-7,161,PDT
RS,85944,CERRO GRANDE DO SUL,2481,2915,2638,2637,-0.03790750568613,17.4929463925836,-1,434,PSL
RS,85960,CAMARGO,1170,1358,753,747,-0.796812749003983,16.0683760683761,-6,188,MDB
RS,85987,PARAÍSO DO SUL,2371,2758,1696,1662,-2.00471698113207,16.3222269084774,-34,387,PDT
RS,86045,AMARAL FERRADOR,1474,1757,1757,1746,-0.626067159931698,19.1994572591588,-11,283,PDT
RS,86070,CIRÍACO,1556,1800,1258,1248,-0.794912559618444,15.681233933162,-10,244,PT
RS,86088,CERRO BRANCO,1463,1722,1131,1116,-1.3262599469496,17.7033492822966,-15,259,PDT
RS,86100,ANDRÉ DA ROCHA,658,733,327,320,-2.14067278287462,11.3981762917933,-7,75,PTB
RS,86142,TRÊS PALMEIRAS,1228,1453,1792,1765,-1.50669642857143,18.3224755700326,-27,225,MDB
RS,86150,CORONEL BICACO,1996,2255,2501,2430,-2.83886445421832,12.9759519038076,-71,259,PSB
RS,86274,DOM FELICIANO,3205,3746,4379,4272,-2.44348024663165,16.8798751950078,-107,541,PTB
RS,86290,DOM PEDRITO,8323,9878,11541,11319,-1.92357681310111,18.6831671272378,-222,1555,PP
RS,86304,AMETISTA DO SUL,2454,2797,2173,2121,-2.3930050621261,13.9771801140994,-52,343,PP
RS,86363,BARRA DO GUARITA,847,948,1119,1091,-2.50223413762288,11.9244391971665,-28,101,PT
RS,86410,ERVAL GRANDE,1388,1600,1819,1817,-0.109950522264979,15.2737752161383,-2,212,PTB
RS,86436,ERVAL SECO,1784,2061,2379,2375,-0.168137873055907,15.5269058295964,-4,277,PSDB
RS,86444,BOM PROGRESSO,788,860,983,921,-6.30722278738556,9.13705583756346,-62,72,PP
RS,86487,CANDIOTA,1654,1974,4114,4090,-0.583373845405932,19.3470374848851,-24,320,MDB
RS,86649,COXILHA,1123,1269,1009,983,-2.57680872150644,13.0008904719501,-26,146,PP
RS,86665,DERRUBADAS,939,1130,1040,1034,-0.576923076923075,20.3407880724175,-6,191,MDB
RS,86681,DOIS IRMÃOS DAS MISSÕES,678,749,840,835,-0.595238095238093,10.4719764011799,-5,71,MDB
RS,86746,GENTIL,881,996,349,341,-2.29226361031518,13.0533484676504,-8,115,PDT
RS,86800,HULHA NEGRA,1243,1439,2307,2292,-0.650195058517555,15.7683024939662,-15,196,PP
RS,86827,INHACORÁ,708,762,789,775,-1.7743979721166,7.6271186440678,-14,54,PTB
RS,86843,ITAPUCA,806,874,558,553,-0.896057347670254,8.43672456575682,-5,68,DEM
RS,86908,LINDOLFO COLLOR,1915,2156,1629,1613,-0.982197667280538,12.5848563968668,-16,241,PP
RS,86916,HORIZONTINA,7489,8192,3813,3577,-6.18935221610281,9.38710108158634,-236,703,PDT
RS,86940,MANOEL VIANA,1697,1986,2312,2271,-1.77335640138409,17.0300530347672,-41,289,PDT
RS,87025,MATO CASTELHANO,1553,1764,590,552,-6.44067796610169,13.586606567933,-38,211,PP
RS,87068,MINAS DO LEÃO,1950,2319,2573,2557,-0.621842207539836,18.9230769230769,-16,369,PP
RS,87076,ILÓPOLIS,2019,2231,679,659,-2.94550810014728,10.5002476473502,-20,212,MDB
RS,87106,MORMAÇO,1129,1279,917,897,-2.18102508178845,13.2860938883968,-20,150,PP
RS,87157,ITATIBA DO SUL,1021,1186,1803,1683,-6.65557404326124,16.1606268364349,-120,165,PT
RS,87246,NOVA SANTA RITA,7164,8152,6538,6473,-0.994187825022941,13.7911781127862,-65,988,PT
RS,87289,NOVO MACHADO,1544,1693,941,938,-0.318809776833151,9.6502590673575,-3,149,PP
RS,87297,LAJEADO,29372,31987,16705,16271,-2.59802454354984,8.90303690589678,-434,2615,PP
RS,87319,LAVRAS DO SUL,1376,1669,2618,2584,-1.2987012987013,21.2936046511628,-34,293,PDT
RS,87343,PASSO DO SOBRADO,2052,2324,1907,1876,-1.6255899318301,13.2553606237817,-31,272,PP
RS,87408,PINHEIRINHO DO VALE,1416,1569,1439,1421,-1.25086865879083,10.8050847457627,-18,153,MDB
RS,87475,MIRAGUAÍ,1306,1477,2007,1935,-3.58744394618834,13.093415007657,-72,171,PT
RS,87556,NÃO-ME-TOQUE,6727,7522,3489,3315,-4.98710232158212,11.818046677568,-174,795,DEM
RS,87564,SAGRADA FAMÍLIA,706,867,955,937,-1.8848167539267,22.8045325779037,-18,161,PT
RS,87629,SANTA TEREZA,963,1051,390,389,-0.256410256410256,9.13811007268952,-1,88,PTB
RS,87645,SANTO ANTÔNIO DO PALMA,746,872,740,730,-1.35135135135135,16.8900804289544,-10,126,PSB
RS,87726,SÃO JOSÉ DOS AUSENTES,1345,1525,878,832,-5.23917995444191,13.3828996282528,-46,180,PSB
RS,87750,PAIM FILHO,1537,1720,1521,1484,-2.43261012491782,11.9063109954457,-37,183,PT
RS,87777,PALMEIRA DAS MISSÕES,9062,10337,9066,8979,-0.959629384513572,14.0697417788568,-87,1275,PT
RS,87793,PALMITINHO,1883,2215,2701,2692,-0.333209922251021,17.6314391927775,-9,332,PDT
RS,87866,SÃO VALÉRIO DO SUL,613,684,1068,1049,-1.77902621722846,11.5823817292007,-19,71,PP
RS,87890,PEJUÇARA,1412,1567,1008,983,-2.48015873015873,10.9773371104816,-25,155,MDB
RS,87947,SINIMBU,2579,3072,2761,2649,-4.05650126765664,19.115936409461,-112,493,DEM
RS,87963,TIRADENTES DO SUL,1446,1604,1941,1934,-0.360638845955696,10.926694329184,-7,158,PSDB
RS,87971,PLANALTO,3066,3448,2806,2779,-0.962223806129725,12.4592302674494,-27,382,MDB
RS,87980,TRAVESSEIRO,836,952,706,701,-0.708215297450421,13.8755980861244,-5,116,MDB
RS,88005,TRÊS FORQUILHAS,1046,1250,1073,1069,-0.372786579683126,19.5028680688337,-4,204,PP
RS,88056,PORTO XAVIER,2969,3319,3051,3010,-1.343821697804,11.7884809700236,-41,350,REPUBLICANOS
RS,88064,VALE DO SOL,3047,3683,3186,3091,-2.98179535467671,20.8729898260584,-95,636,PP
RS,88110,REDENTORA,1614,1848,3128,3061,-2.14194373401535,14.4981412639405,-67,234,MDB
RS,88218,RODEIO BONITO,1958,2251,2053,1977,-3.70189965903556,14.9642492339122,-76,293,PTB
RS,88234,ROLANTE,7558,8717,4721,4709,-0.254183435712774,15.3347446414395,-12,1159,PP
RS,88250,RONDA ALTA,2626,2890,3246,3244,-0.0616142945163323,10.0533130236101,-2,264,PDT
RS,88269,CHUVISCA,2059,2356,1191,1155,-3.02267002518891,14.4244779018941,-36,297,PSB
RS,88285,ESPERANÇA DO SUL,953,1077,1411,1340,-5.03189227498229,13.0115424973767,-71,124,MDB
RS,88293,ROQUE GONZALES,2027,2348,2148,2119,-1.35009310986964,15.836211149482,-29,321,PP
RS,88323,HERVEIRAS,674,764,1303,1298,-0.383729854182657,13.353115727003,-5,90,PTB
RS,88358,SANANDUVA,6807,7685,3341,3273,-2.03531876683628,12.8984868517702,-68,878,PP
RS,88366,FAZENDA VILANOVA,1406,1593,1153,1132,-1.8213356461405,13.3001422475107,-21,187,PDT
RS,88374,SANTA BÁRBARA DO SUL,3088,3543,2136,2086,-2.34082397003745,14.7344559585492,-50,455,
RS,88420,BENJAMIN CONSTANT DO SUL,582,646,1021,1010,-1.07737512242899,10.9965635738832,-11,64,CIDADANIA
RS,88447,MAÇAMBARÁ,1321,1535,1420,1404,-1.12676056338028,16.1998485995458,-16,214,PSDB
RS,88471,SANTA ROSA,28139,30871,15136,14897,-1.57901691331924,9.70894488077045,-239,2732,PP
RS,88480,UNISTALDA,956,1102,972,923,-5.04115226337448,15.2719665271966,-49,146,PP
RS,88544,MUITOS CAPÕES,1332,1462,647,641,-0.927357032457499,9.75975975975976,-6,130,DEM
RS,88595,SANTO AUGUSTO,4160,4761,4228,4222,-0.141911069063383,14.4471153846154,-6,601,DEM
RS,88625,BARRA DO QUARAÍ,871,1000,1299,1220,-6.08160123171671,14.8105625717566,-79,129,PDT
RS,88684,NOVO CABRAIS,1565,1741,1214,1197,-1.4003294892916,11.2460063897764,-17,176,PT
RS,88722,TABAÍ,1582,1758,1424,1372,-3.65168539325843,11.1251580278129,-52,176,DEM
RS,88811,SÃO LUIZ GONZAGA,8397,9966,9815,9629,-1.8950585838003,18.6852447302608,-186,1569,PP
RS,88820,MARQUES DE SOUZA,1660,1825,988,978,-1.01214574898786,9.93975903614457,-10,165,PP
RS,88846,CHUÍ,920,1068,1989,1973,-0.804424333836096,16.0869565217391,-16,148,DEM
RS,88862,ARARICÁ,2732,3117,1615,1558,-3.52941176470588,14.0922401171303,-57,385,PSL
RS,88870,SÃO NICOLAU,1112,1298,1884,1870,-0.743099787685775,16.726618705036,-14,186,PP
RS,88889,PASSA SETE,1286,1507,1524,1523,-0.0656167979002587,17.1850699844479,-1,221,PTB
RS,88994,SAPIRANGA,28177,31721,18216,18034,-0.999121651295565,12.5776342406928,-182,3544,PP
RS,89060,BOA VISTA DO INCRA,976,1083,756,718,-5.02645502645502,10.9631147540984,-38,107,PP
RS,89117,SERTÃO,2442,2730,1428,1393,-2.45098039215687,11.7936117936118,-35,288,MDB
RS,89176,SOBRADINHO,4269,4985,3718,3717,-0.0268961807423307,16.7720777699695,-1,716,MDB
RS,89192,SOLEDADE,7667,9030,8637,8329,-3.56605302767165,17.7774879353072,-308,1363,MDB
RS,89214,TAPEJARA,9687,11109,3259,3239,-0.61368517950291,14.6794673273459,-20,1422,PP
RS,89230,TAPERA,3382,3842,2783,2772,-0.395256916996045,13.6014192785334,-11,460,MDB
RS,89265,JACUIZINHO,636,729,912,898,-1.53508771929824,14.622641509434,-14,93,PP
RS,89281,LAGOA BONITA DO SUL,760,894,996,985,-1.10441767068273,17.6315789473684,-11,134,PP
RS,89290,TAQUARI,7731,8695,6903,6763,-2.02810372301898,12.4692795239943,-140,964,PDT
RS,89311,TENENTE PORTELA,3373,3836,4483,4430,-1.1822440330136,13.7266528313075,-53,463,PSDB
RS,89389,QUATRO IRMÃOS,775,857,523,514,-1.7208413001912,10.5806451612903,-9,82,PP
RS,89397,TRÊS DE MAIO,8922,9889,4997,4957,-0.8004802881729,10.8383770455055,-40,967,PP
RS,89451,TUCUNDUVA,2469,2701,1242,1240,-0.161030595813205,9.39651680842446,-2,232,PDT
RS,89478,TUPANCIRETÃ,5620,6510,6218,6107,-1.78513991637183,15.8362989323843,-111,890,PP
RS,89559,VENÂNCIO AIRES,23960,27288,15558,15514,-0.28281270086129,13.889816360601,-44,3328,PDT
RS,89567,PEDRAS ALTAS,418,508,1006,997,-0.894632206759438,21.5311004784689,-9,90,PP
RS,89575,VERA CRUZ,7830,9009,6996,6896,-1.42938822184105,15.0574712643678,-100,1179,PSB
RS,89656,VICENTE DUTRA,1559,1767,1323,1279,-3.32577475434618,13.3418858242463,-44,208,MDB
RS,89699,VICTOR GRAEFF,1226,1383,696,693,-0.431034482758619,12.8058727569331,-3,157,MDB
RS,89753,SALTO DO JACUÍ,2590,2926,3292,3290,-0.0607533414337835,12.972972972973,-2,336,PP
RS,98213,TEUTÔNIA,11289,12726,7230,7126,-1.43845089903181,12.7292054212065,-104,1437,PDT
RS,98256,PAROBÉ,17795,20009,11353,11312,-0.361138025191576,12.4416971059286,-41,2214,PDT
RS,98299,JÓIA,2027,2321,2857,2807,-1.75008750437522,14.5041933892452,-50,294,PP
SC,80063,APIÚNA,4401,4886,1705,1701,-0.234604105571845,11.0202226766644,-4,485,PL
SC,80128,VITOR MEIRELES,2246,2525,1108,1090,-1.62454873646209,12.4220837043633,-18,279,PP
SC,80292,ARMAZÉM,3787,4165,1408,1406,-0.142045454545459,9.98151571164509,-2,378,PSD
SC,80462,VARGEM,847,1054,975,970,-0.512820512820511,24.4391971664699,-5,207,PL
SC,80608,RIO RUFINO,1015,1174,698,696,-0.286532951289398,15.6650246305419,-2,159,PSD
SC,80667,CALMON,681,792,1567,1518,-3.12699425654116,16.2995594713656,-49,111,PP
SC,80764,NOVO HORIZONTE,1088,1221,910,895,-1.64835164835165,12.2242647058824,-15,133,PSDB
SC,80845,OURO VERDE,933,1048,604,601,-0.496688741721851,12.3258306538049,-3,115,PL
SC,80900,MACIEIRA,667,757,694,682,-1.72910662824207,13.4932533733134,-12,90,MDB
SC,80918,CUNHA PORÃ,5617,6192,1212,1208,-0.330033003300334,10.2367811999288,-4,575,PSDB
SC,80942,SÃO CRISTÓVÃO DO SUL,1360,1507,1139,1082,-5.00438981562774,10.8088235294118,-57,147,PSDB
SC,81000,SANGÃO,5036,5565,1418,1404,-0.987306064880111,10.5043685464655,-14,529,PP
SC,81043,CORDILHEIRA ALTA,1972,2232,1185,1166,-1.60337552742617,13.184584178499,-19,260,PSD
SC,81108,CORONEL MARTINS,793,885,774,771,-0.387596899224807,11.6015132408575,-3,92,PSD
SC,81191,GRÃO-PARÁ,3267,3740,1045,1028,-1.62679425837321,14.4781144781145,-17,473,PP
SC,81337,IBICARÉ,1637,1802,650,649,-0.153846153846149,10.0794135613928,-1,165,MDB
SC,81914,LEBON RÉGIS,2543,3030,3671,3624,-1.28030509397984,19.1506095163193,-47,487,PDT
SC,82066,MAREMA,1034,1131,600,586,-2.33333333333333,9.38104448742747,-14,97,PP
SC,82090,MATOS COSTA,756,838,982,959,-2.34215885947047,10.8465608465608,-23,82,PDT
SC,82155,MONDAÍ,3188,3807,2436,2420,-0.656814449917897,19.4165621079046,-16,619,PP
SC,82830,RIO DAS ANTAS,2633,2925,1228,1221,-0.570032573289903,11.0900113938473,-7,292,MDB
SC,83054,SANTA CECÍLIA,4707,5514,3929,3865,-1.62891320946805,17.144678138942,-64,807,MDB
SC,83437,SCHROEDER,7873,8845,2606,2596,-0.383729854182657,12.3459926330497,-10,972,MDB
SE,31011,AMPARO DE SÃO FRANCISCO,547,559,1472,1445,-1.83423913043478,2.19378427787935,-27,12,PSC
SE,31135,BREJO GRANDE,1061,1070,4197,4077,-2.85918513223731,0.848256361922717,-120,9,PSD
SE,31534,ILHA DAS FLORES,1060,1111,4168,3910,-6.19001919385797,4.81132075471698,-258,51,PSC
SE,31674,JAPOATÃ,1840,1949,6362,6340,-0.345803206538819,5.92391304347826,-22,109,PL
SE,31755,MALHADA DOS BOIS,580,676,2300,2269,-1.34782608695653,16.551724137931,-31,96,PSD
SE,31852,MURIBECA,1371,1448,3936,3899,-0.940040650406504,5.61633843909555,-37,77,PL
SE,31879,NEÓPOLIS,2381,2471,7538,7507,-0.411249668347047,3.77992440151198,-31,90,PL
SE,32298,SANTA ROSA DE LIMA,765,840,2320,2310,-0.431034482758619,9.80392156862746,-10,75,PSD
SP,61344,CANITAR,1408,1578,1448,1387,-4.21270718232044,12.0738636363636,-61,170,CIDADANIA
SP,61930,BALBINOS,584,639,452,442,-2.21238938053098,9.41780821917808,-10,55,PSDB
SP,63592,COSMORAMA,3077,3443,2066,2060,-0.290416263310744,11.8947026324342,-6,366,PP
SP,64173,FLORA RICA,509,576,563,555,-1.42095914742452,13.1630648330059,-8,67,PTB
SP,64238,FLORÍNEA,905,1002,1021,1016,-0.489715964740456,10.7182320441989,-5,97,PSDB
SP,66516,LUCIANÓPOLIS,767,817,780,777,-0.384615384615383,6.51890482398958,-3,50,PSDB
SP,67679,NOVA LUZITÂNIA,872,1005,1092,1065,-2.47252747252748,15.2522935779817,-27,133,PTB
SP,67830,ORIENTE,2201,2503,1466,1456,-0.682128240109137,13.721035892776,-10,302,PDT
SP,69370,QUEIROZ,1185,1292,1042,1037,-0.479846449136279,9.0295358649789,-5,107,PSD
SP,71250,SARUTAIÁ,923,1030,1307,1306,-0.0765110941086444,11.5926327193933,-1,107,PTB
SP,72150,UNIÃO PAULISTA,623,679,512,503,-1.7578125,8.98876404494382,-9,56,PV
TO,73008,ABREULÂNDIA,736,749,1052,1032,-1.90114068441065,1.7663043478261,-20,13,PT
TO,73016,PIRAQUÊ,617,653,1006,974,-3.18091451292246,5.83468395461912,-32,36,PV
TO,73024,RIACHINHO,987,1010,1744,1674,-4.01376146788991,2.33029381965553,-70,23,SOLIDARIEDADE
TO,73032,DARCINÓPOLIS,1068,1130,1988,1960,-1.40845070422535,5.80524344569289,-28,62,MDB
TO,73040,PALMEIRAS DO TOCANTINS,1105,1156,1966,1920,-2.33977619532044,4.61538461538462,-46,51,MDB
TO,73067,CACHOEIRINHA,453,460,877,849,-3.19270239452679,1.54525386313467,-28,7,DEM
TO,73075,ANGICO,753,785,1158,1124,-2.93609671848014,4.24966799468791,-34,32,PP
TO,73083,PALMEIRANTE,889,945,1968,1902,-3.35365853658537,6.29921259842521,-66,56,PTB
TO,73091,CAMPOS LINDOS,1489,1739,3210,3001,-6.51090342679128,16.7897918065816,-209,250,SOLIDARIEDADE
TO,73113,LAGOA DO TOCANTINS,707,749,1567,1537,-1.91448627951499,5.94059405940595,-30,42,PSD
TO,73121,BOM JESUS DO TOCANTINS,1059,1137,1409,1393,-1.13555713271823,7.36543909348442,-16,78,DEM
TO,73130,SANTA MARIA DO TOCANTINS,789,838,1101,1035,-5.99455040871935,6.2103929024081,-66,49,DEM
TO,73156,SANDOLÂNDIA,1244,1322,1258,1222,-2.86168521462639,6.2700964630225,-36,78,PSC
TO,73180,SÃO MIGUEL DO TOCANTINS,2091,2227,4089,4074,-0.366837857666913,6.5040650406504,-15,136,SOLIDARIEDADE
TO,73199,TABOCÃO,964,1066,1270,1258,-0.944881889763782,10.5809128630705,-12,102,PSD
TO,73229,RECURSOLÂNDIA,550,587,1615,1577,-2.35294117647059,6.72727272727274,-38,37,MDB
TO,73237,TUPIRATINS,405,423,898,891,-0.779510022271712,4.44444444444445,-7,18,DEM
TO,73245,BRASILÂNDIA DO TOCANTINS,558,602,851,793,-6.81551116333725,7.88530465949822,-58,44,PSC
TO,73253,JUARINA,663,703,936,877,-6.3034188034188,6.03318250377074,-59,40,PTB
TO,73261,PAU D ARCO,1124,1186,1420,1307,-7.95774647887324,5.51601423487544,-113,62,PP
TO,73288,SÃO BENTO DO TOCANTINS,949,975,2411,2317,-3.89879717959353,2.73972602739727,-94,26,PSD
TO,73296,ESPERANTINA,1192,1257,3242,3212,-0.925354719309068,5.45302013422819,-30,65,PP
TO,73300,CARIRI DO TOCANTINS,1219,1338,1413,1360,-3.75088464260439,9.76210008203446,-53,119,DEM
TO,73334,ARAGOMINAS,1190,1277,2201,2120,-3.68014538845979,7.3109243697479,-81,87,SOLIDARIEDADE
TO,73342,MURICILÂNDIA,701,752,1363,1295,-4.98899486426999,7.2753209700428,-68,51,PL
TO,73350,SANTA FÉ DO ARAGUAIA,1580,1689,2308,2264,-1.90641247833622,6.89873417721518,-44,109,SOLIDARIEDADE
TO,73369,JAÚ DO TOCANTINS,881,968,1211,1143,-5.61519405450042,9.87514188422247,-68,87,PSD
TO,73377,SUCUPIRA,548,612,694,661,-4.7550432276657,11.6788321167883,-33,64,PSD
TO,73385,LAGOA DA CONFUSÃO,3071,3308,3345,3267,-2.33183856502243,7.71735591012699,-78,237,DEM
TO,73393,SÃO SALVADOR DO TOCANTINS,436,484,1174,1120,-4.59965928449745,11.0091743119266,-54,48,PT
TO,73407,LAJEADO,1082,1165,1313,1258,-4.18888042650419,7.67097966728281,-55,83,MDB
TO,73415,RIO DOS BOIS,655,699,1220,1198,-1.80327868852459,6.71755725190839,-22,44,DEM
TO,73431,RIO DA CONCEIÇÃO,443,459,1000,965,-3.5,3.61173814898419,-35,16,PT
TO,73458,TUPIRAMA,517,568,881,815,-7.49148694665154,9.86460348162477,-66,51,MDB
TO,73466,OLIVEIRA DE FÁTIMA,454,499,685,652,-4.81751824817518,9.91189427312775,-33,45,SOLIDARIEDADE
TO,73474,CHAPADA DE AREIA,817,849,881,812,-7.83200908059024,3.91676866585067,-69,32,MDB
TO,73482,CHAPADA DA NATIVIDADE,448,489,1581,1570,-0.695762175838077,9.15178571428572,-11,41,PTB
TO,73504,TALISMÃ,809,872,1045,982,-6.02870813397129,7.78739184177997,-63,63,DEM
TO,73512,AGUIARNÓPOLIS,966,1039,1862,1860,-0.10741138560687,7.55693581780539,-2,73,MDB
TO,73539,SANTA TEREZINHA DO TOCANTINS,514,558,1040,1020,-1.92307692307693,8.56031128404668,-20,44,CIDADANIA
TO,73547,SANTA RITA DO TOCANTINS,711,741,831,774,-6.85920577617328,4.21940928270042,-57,30,DEM
TO,73555,CRIXÁS DO TOCANTINS,533,601,709,670,-5.50070521861778,12.7579737335835,-39,68,SOLIDARIEDADE
TO,73563,MONTE SANTO DO TOCANTINS,978,1055,824,801,-2.79126213592233,7.87321063394684,-23,77,PSL
TO,73571,PUGMIL,783,834,741,737,-0.539811066126861,6.51340996168583,-4,51,DEM
TO,73580,BANDEIRANTES DO TOCANTINS,1055,1101,1044,985,-5.65134099616859,4.36018957345972,-59,46,PP
TO,73598,IPUEIRAS,344,353,1023,950,-7.13587487781037,2.61627906976745,-73,9,DEM
TO,73601,LAVANDEIRA,441,459,869,833,-4.14269275028769,4.08163265306123,-36,18,PSD
TO,73610,BARRA DO OURO,864,951,1812,1710,-5.62913907284768,10.0694444444444,-102,87,PV
TO,92002,BERNARDO SAYÃO,1295,1401,1278,1227,-3.9906103286385,8.18532818532818,-51,106,CIDADANIA
TO,92070,ALMAS,1108,1248,2546,2534,-0.471327572663005,12.6353790613718,-12,140,MDB
TO,92088,CASEARA,1054,1140,1815,1757,-3.19559228650138,8.15939278937381,-58,86,DEM
TO,92134,ALVORADA,2772,2965,2491,2438,-2.12765957446809,6.96248196248197,-53,193,DEM
TO,92193,ANANÁS,1977,2145,3332,3224,-3.24129651860744,8.49772382397571,-108,168,PSD
TO,92240,GOIANORTE,1486,1589,1903,1748,-8.14503415659486,6.9313593539704,-155,103,SOLIDARIEDADE
TO,92304,MARIANÓPOLIS DO TOCANTINS,1067,1209,1444,1414,-2.07756232686981,13.3083411433927,-30,142,DEM
TO,92371,ARAGUACEMA,1149,1359,2250,2130,-5.33333333333333,18.2767624020888,-120,210,MDB
TO,92398,ARAGUAÇU,3183,3441,1450,1446,-0.275862068965516,8.10556079170595,-4,258,AVANTE
TO,92401,NOVA ROSALÂNDIA,1031,1174,1014,952,-6.11439842209073,13.8700290979631,-62,143,PSC
TO,92452,ARAPOEMA,1407,1503,1980,1955,-1.26262626262627,6.8230277185501,-25,96,PV
TO,92487,PEQUIZEIRO,1317,1397,1920,1851,-3.59375,6.07441154138193,-69,80,PSD
TO,92509,PORTO ALEGRE DO TOCANTINS,431,483,1162,1150,-1.03270223752151,12.0649651972158,-12,52,PL
TO,92533,AURORA DO TOCANTINS,729,773,1482,1439,-2.90148448043185,6.03566529492456,-43,44,PV
TO,92541,SAMPAIO,754,788,1866,1833,-1.76848874598071,4.50928381962865,-33,34,SOLIDARIEDADE
TO,92576,AXIXÁ DO TOCANTINS,2546,2712,4084,4035,-1.1998041136141,6.52003142183817,-49,166,PTB
TO,92584,SANTA ROSA DO TOCANTINS,881,924,2284,2150,-5.86690017513135,4.88081725312146,-134,43,SOLIDARIEDADE
TO,92592,BABAÇULÂNDIA,1461,1600,3419,3404,-0.438724773325538,9.51403148528405,-15,139,PSB
TO,92681,SÃO VALÉRIO,699,751,2025,2013,-0.592592592592589,7.43919885550788,-12,52,PSD
TO,93211,COUTO MAGALHÃES,1140,1235,2092,2054,-1.81644359464627,8.33333333333333,-38,95,DEM
TO,93238,CRISTALÂNDIA,1724,1865,2295,2213,-3.57298474945533,8.17865429234339,-82,141,PP
TO,93556,FILADÉLFIA,1621,1732,2958,2909,-1.65652467883706,6.84762492288711,-49,111,REPUBLICANOS
TO,93653,FORMOSO DO ARAGUAIA,5361,5747,4787,4698,-1.85920200543138,7.2001492258907,-89,386,PTB
TO,94056,ITACAJÁ,1367,1503,2666,2655,-0.412603150787694,9.94879297732261,-11,136,PSC
TO,94170,ITAPORÃ DO TOCANTINS,786,816,1076,979,-9.01486988847584,3.81679389312977,-97,30,DEM
TO,94692,MONTE DO CARMO,1128,1287,2206,2193,-0.589301903898454,14.0957446808511,-13,159,DEM
TO,94811,NATIVIDADE,1731,1865,2943,2928,-0.509683995922527,7.74119006354708,-15,134,PP
TO,94838,NAZARÉ,775,827,2271,2248,-1.01276970497578,6.70967741935484,-23,52,PTB
TO,94994,NOVO ACORDO,1176,1222,1670,1626,-2.63473053892216,3.91156462585034,-44,46,DEM
TO,95273,PEIXE,1635,1764,3477,3454,-0.661489790048897,7.88990825688074,-23,129,MDB
TO,95290,COLMÉIA,2823,2992,1937,1878,-3.04594734124936,5.98653914275593,-59,169,PL
TO,95338,GOIATINS,1540,1715,4447,4392,-1.23678884641332,11.3636363636364,-55,175,AVANTE
TO,95370,PINDORAMA DO TOCANTINS,1012,1074,1659,1633,-1.56720916214587,6.12648221343874,-26,62,PL
TO,95478,PIUM,2064,2157,2236,2093,-6.3953488372093,4.50581395348837,-143,93,PSDB
TO,95532,PONTE ALTA DO TOCANTINS,1786,1916,2104,2091,-0.617870722433456,7.27883538633818,-13,130,PSD
TO,96032,SÃO SEBASTIÃO DO TOCANTINS,626,673,1799,1768,-1.72317954419122,7.50798722044728,-31,47,MDB
TO,96199,TOCANTÍNIA,1035,1109,2854,2845,-0.315346881569722,7.14975845410628,-9,74,SOLIDARIEDADE
TO,96598,SILVANÓPOLIS,1209,1372,2148,2049,-4.60893854748603,13.4822167080232,-99,163,PSD
TO,96652,WANDERLÂNDIA,1883,2055,3178,3129,-1.54185022026432,9.1343600637281,-49,172,PSC
TO,96792,RIO SONO,1342,1345,1870,1828,-2.24598930481283,0.223546944858422,-42,3,DEM
TO,96830,FÁTIMA,1246,1288,1228,1185,-3.50162866449512,3.37078651685394,-43,42,PTB
TO,96954,ALIANÇA DO TOCANTINS,1322,1446,1735,1685,-2.88184438040345,9.37972768532527,-50,124,PTB
TO,96970,APARECIDA DO RIO NEGRO,1293,1437,1780,1775,-0.28089887640449,11.1368909512761,-5,144,MDB
TO,96997,BARROLÂNDIA,1537,1737,1844,1830,-0.759219088937091,13.0123617436565,-14,200,DEM
ZZ,29360,BEIRUTE,947,1099,1601,1591,-0.624609618988137,16.0506863780359,-10,152,
ZZ,29394,BISSAU,21,25,23,20,-13.0434782608696,19.0476190476191,-3,4,
ZZ,29459,BUDAPESTE,72,83,491,481,-2.03665987780041,15.2777777777778,-10,11,
ZZ,29467,BUENOS AIRES,1910,2240,4406,4373,-0.748978665456201,17.2774869109948,-33,330,
ZZ,29556,CIUDAD DEL ESTE,2561,2719,240,238,-0.83333333333333,6.16946505271379,-2,158,
ZZ,29840,JACARTA,30,32,16,15,-6.25,6.66666666666667,-1,2,
ZZ,30210,NOVA DELHI,12,14,27,23,-14.8148148148148,16.6666666666667,-4,2,
ZZ,30317,PEQUIM,19,23,48,47,-2.08333333333334,21.0526315789474,-1,4,
ZZ,30414,RAMALLAH,52,61,592,584,-1.35135135135135,17.3076923076923,-8,9,
ZZ,30538,SEUL,53,70,130,126,-3.07692307692308,32.0754716981132,-4,17,
ZZ,30740,VARSÓVIA,55,68,213,212,-0.469483568075113,23.6363636363636,-1,13,
